"subject","cond","t","rt.N","rt.W","difference"
1,3,1,1007,1020,-13
1,3,2,1042,990,52
1,3,3,844,772,72
1,3,4,1481,961,520
1,3,5,821,783,38
1,3,6,814,722,92
1,3,7,861,690,171
1,3,8,969,814,155
1,3,9,887,711,176
1,3,10,950,742,208
1,3,11,867,754,113
1,3,12,816,738,78
1,3,13,1005,694,311
1,3,14,867,770,97
1,3,15,830,679,151
1,3,16,742,765,-23
1,3,17,805,888,-83
1,3,18,848,827,21
1,3,19,783,797,-14
1,3,20,839,736,103
1,3,21,947,878,69
1,3,22,809,733,76
1,3,23,838,797,41
1,3,24,900,809,91
1,3,25,732,652,80
1,3,26,833,787,46
1,3,27,794,804,-10
1,3,28,831,1025,-194
1,3,29,793,883,-90
1,3,30,868,920,-52
1,3,32,1026,851,175
1,3,33,725,916,-191
1,3,34,753,1030,-277
1,3,35,909,630,279
1,3,36,775,705,70
1,3,37,930,915,15
1,3,38,901,1295,-394
1,3,39,851,881,-30
1,3,41,827,801,26
1,3,42,801,724,77
1,3,43,858,706,152
1,3,44,768,752,16
1,3,45,765,717,48
1,3,46,838,731,107
1,3,47,794,693,101
1,3,48,834,685,149
1,3,49,821,723,98
1,3,50,881,789,92
1,3,51,930,764,166
1,3,52,883,1140,-257
1,3,53,855,875,-20
1,3,54,890,902,-12
1,3,55,904,956,-52
1,3,56,1012,893,119
1,3,57,972,1020,-48
1,3,58,845,1000,-155
1,3,59,809,894,-85
1,3,60,828,740,88
1,3,61,1027,1039,-12
1,3,62,913,1017,-104
1,3,63,829,787,42
1,3,64,906,957,-51
1,3,65,978,908,70
1,3,66,882,778,104
1,3,67,931,700,231
1,3,69,783,722,61
1,3,70,1319,1311,8
1,3,71,892,740,152
1,3,72,760,821,-61
2,2,1,967,1570,-603
2,2,2,918,1194,-276
2,2,3,919,962,-43
2,2,4,871,1086,-215
2,2,5,852,1189,-337
2,2,6,863,742,121
2,2,7,878,1125,-247
2,2,8,1065,1094,-29
2,2,9,1240,1227,13
2,2,10,971,788,183
2,2,11,840,736,104
2,2,12,878,700,178
2,2,13,904,879,25
2,2,14,1138,1348,-210
2,2,15,920,789,131
2,2,16,792,1029,-237
2,2,17,986,808,178
2,2,21,792,809,-17
2,2,22,855,877,-22
2,2,29,819,818,1
2,2,30,815,1470,-655
2,2,34,905,765,140
2,2,53,909,1549,-640
2,2,54,1105,1205,-100
2,2,56,1447,1257,190
3,2,1,897,1120,-223
3,2,2,1260,1013,247
3,2,3,884,899,-15
3,2,4,879,949,-70
3,2,5,826,855,-29
3,2,6,1021,1108,-87
3,2,7,946,961,-15
3,2,8,873,866,7
3,2,11,1794,1144,650
3,2,13,894,971,-77
3,2,14,880,1013,-133
3,2,15,931,987,-56
3,2,17,1087,1024,63
3,2,18,946,1008,-62
3,2,19,906,1175,-269
3,2,20,1387,1100,287
3,2,21,1001,1019,-18
3,2,22,937,1094,-157
3,2,23,914,972,-58
3,2,24,899,940,-41
3,2,25,1017,1086,-69
3,2,26,999,992,7
3,2,27,895,905,-10
3,2,28,895,938,-43
3,2,29,922,979,-57
3,2,30,1447,926,521
3,2,31,918,1129,-211
3,2,32,920,903,17
3,2,33,1172,1018,154
3,2,34,951,1070,-119
3,2,35,952,958,-6
3,2,36,950,972,-22
3,2,37,1019,965,54
3,2,38,955,1079,-124
3,2,39,850,1078,-228
3,2,40,838,1156,-318
3,2,41,1046,1053,-7
3,2,42,899,1133,-234
3,2,43,973,969,4
3,2,44,960,1029,-69
3,2,45,956,968,-12
3,2,48,789,653,136
3,2,50,787,1156,-369
3,2,51,865,1013,-148
3,2,52,944,1041,-97
3,2,53,817,905,-88
3,2,55,772,1156,-384
3,2,56,824,881,-57
3,2,57,1551,982,569
3,2,58,1159,945,214
3,2,59,1141,1077,64
3,2,60,939,1061,-122
3,2,61,896,978,-82
3,2,62,910,949,-39
3,2,63,881,946,-65
3,2,64,951,1182,-231
3,2,65,911,926,-15
3,2,66,894,952,-58
3,2,67,952,941,11
3,2,70,1986,1886,100
3,2,71,1467,963,504
4,2,1,990,1143,-153
4,2,2,1114,1076,38
4,2,3,974,1168,-194
4,2,4,1164,959,205
4,2,5,1042,1074,-32
4,2,6,1081,1007,74
4,2,7,1083,1235,-152
4,2,8,993,883,110
4,2,9,1030,976,54
4,2,10,960,978,-18
4,2,11,993,953,40
4,2,12,926,975,-49
4,2,13,904,809,95
4,2,15,899,785,114
4,2,16,928,842,86
4,2,18,860,725,135
4,2,19,832,865,-33
4,2,20,821,729,92
4,2,21,889,761,128
4,2,22,959,746,213
4,2,23,1170,838,332
4,2,24,813,654,159
4,2,25,720,763,-43
4,2,26,869,806,63
4,2,27,885,886,-1
4,2,28,809,698,111
4,2,29,880,732,148
4,2,30,724,851,-127
4,2,31,869,897,-28
4,2,32,1090,804,286
4,2,33,841,747,94
4,2,34,876,717,159
4,2,35,785,707,78
4,2,36,850,940,-90
4,2,37,852,804,48
4,2,38,1082,864,218
4,2,39,804,766,38
4,2,40,718,331,387
4,2,41,781,341,440
4,2,42,779,317,462
4,2,43,913,241,672
4,2,44,781,279,502
4,2,45,723,187,536
4,2,46,1186,251,935
4,2,47,983,367,616
4,2,48,917,168,749
4,2,49,1011,166,845
4,2,52,940,74,866
4,2,53,884,268,616
4,2,54,959,11,948
4,2,55,932,14,918
4,2,57,1079,65,1014
4,2,58,486,304,182
4,2,59,894,1247,-353
4,2,60,949,140,809
4,2,62,959,81,878
4,2,63,891,141,750
4,2,64,958,31,927
4,2,65,867,1006,-139
4,2,66,1113,336,777
4,2,67,965,334,631
4,2,68,1060,629,431
4,2,69,534,440,94
4,2,71,959,199,760
4,2,72,784,240,544
5,1,1,774,1093,-319
5,1,2,838,1003,-165
5,1,3,804,828,-24
5,1,4,857,771,86
5,1,5,811,742,69
5,1,6,738,737,1
5,1,7,795,691,104
5,1,8,732,686,46
5,1,9,792,774,18
5,1,10,724,862,-138
5,1,11,704,683,21
5,1,12,694,898,-204
5,1,13,826,974,-148
5,1,14,769,768,1
5,1,15,774,856,-82
5,1,16,785,714,71
5,1,17,657,659,-2
5,1,18,711,785,-74
5,1,19,735,678,57
5,1,20,857,769,88
5,1,21,728,692,36
5,1,22,864,707,157
5,1,23,698,689,9
5,1,25,794,578,216
5,1,26,765,688,77
5,1,27,727,683,44
5,1,28,894,753,141
5,1,29,685,723,-38
5,1,30,777,745,32
5,1,31,739,727,12
5,1,32,726,686,40
5,1,33,726,672,54
5,1,34,719,714,5
5,1,35,709,702,7
5,1,36,708,751,-43
5,1,37,754,659,95
5,1,38,673,671,2
5,1,39,806,717,89
5,1,40,692,772,-80
5,1,41,766,687,79
5,1,42,916,658,258
5,1,43,689,615,74
5,1,44,728,657,71
5,1,45,708,723,-15
5,1,46,801,679,122
5,1,47,710,686,24
5,1,48,843,646,197
5,1,49,722,636,86
5,1,50,671,721,-50
5,1,51,747,740,7
5,1,52,721,692,29
5,1,53,836,676,160
5,1,54,724,707,17
5,1,55,704,660,44
5,1,56,748,683,65
5,1,57,828,617,211
5,1,58,713,652,61
5,1,60,807,705,102
5,1,61,734,696,38
5,1,62,764,693,71
5,1,63,681,595,86
5,1,64,757,723,34
5,1,65,724,755,-31
5,1,66,763,716,47
5,1,67,689,607,82
5,1,68,710,697,13
5,1,69,757,659,98
5,1,70,727,684,43
5,1,71,797,781,16
5,1,72,706,838,-132
6,3,1,942,1637,-695
6,3,2,1030,1312,-282
6,3,3,932,1445,-513
6,3,5,969,1132,-163
6,3,6,912,1089,-177
6,3,7,918,1168,-250
6,3,8,874,1202,-328
6,3,9,1117,1246,-129
6,3,10,996,1375,-379
6,3,11,971,1349,-378
6,3,12,895,1112,-217
6,3,13,803,1180,-377
6,3,14,925,1203,-278
6,3,15,838,1095,-257
6,3,16,921,1070,-149
6,3,17,908,995,-87
6,3,18,926,1151,-225
6,3,19,1004,1044,-40
6,3,20,1226,1214,12
6,3,21,910,982,-72
6,3,22,855,1038,-183
6,3,23,883,1082,-199
6,3,24,916,1037,-121
6,3,25,865,1291,-426
6,3,26,841,1230,-389
6,3,27,875,1133,-258
6,3,28,848,993,-145
6,3,29,1081,920,161
6,3,30,974,1056,-82
6,3,31,826,1078,-252
6,3,32,832,1008,-176
6,3,33,991,1175,-184
6,3,34,1071,1012,59
6,3,35,1110,1194,-84
6,3,36,872,1036,-164
6,3,37,1036,1008,28
6,3,38,811,1300,-489
6,3,40,1261,984,277
6,3,41,888,980,-92
6,3,42,834,968,-134
6,3,43,977,1056,-79
6,3,44,817,1239,-422
6,3,45,831,892,-61
6,3,46,1241,1035,206
6,3,47,979,970,9
6,3,48,868,1106,-238
6,3,49,860,1135,-275
6,3,50,864,851,13
6,3,51,824,1021,-197
6,3,52,892,1140,-248
6,3,54,883,912,-29
6,3,55,793,1067,-274
6,3,56,806,1085,-279
6,3,57,1184,1100,84
6,3,58,998,1095,-97
6,3,59,817,1001,-184
6,3,60,853,1015,-162
6,3,61,936,1014,-78
6,3,63,1005,1020,-15
6,3,64,891,1031,-140
6,3,65,817,971,-154
6,3,66,1316,1140,176
6,3,67,889,1025,-136
6,3,68,1018,986,32
6,3,69,830,977,-147
6,3,70,892,966,-74
6,3,71,865,1040,-175
6,3,72,801,1044,-243
7,1,1,914,1029,-115
7,1,2,880,920,-40
7,1,3,968,881,87
7,1,4,964,859,105
7,1,5,1018,824,194
7,1,6,743,948,-205
7,1,7,941,956,-15
7,1,8,893,1094,-201
7,1,9,932,891,41
7,1,10,770,1044,-274
7,1,11,766,1046,-280
7,1,12,854,813,41
7,1,13,772,811,-39
7,1,14,891,782,109
7,1,15,855,990,-135
7,1,16,889,775,114
7,1,18,772,923,-151
7,1,20,761,408,353
7,1,22,877,874,3
7,1,23,644,674,-30
7,1,24,772,917,-145
7,1,25,765,933,-168
7,1,26,1017,883,134
7,1,27,833,427,406
7,1,28,876,314,562
7,1,30,960,265,695
7,1,31,681,86,595
7,1,32,855,215,640
7,1,33,589,3,586
7,1,34,608,86,522
7,1,35,811,52,759
7,1,36,772,331,441
7,1,37,874,28,846
7,1,38,740,29,711
7,1,39,426,192,234
7,1,40,584,27,557
7,1,41,1015,258,757
7,1,42,908,233,675
7,1,43,832,7,825
7,1,44,950,22,928
7,1,45,614,81,533
7,1,46,1191,14,1177
7,1,48,668,61,607
7,1,49,875,326,549
7,1,50,974,85,889
7,1,51,1116,187,929
7,1,52,940,283,657
7,1,53,924,100,824
7,1,54,1218,276,942
7,1,56,1190,684,506
7,1,57,1097,355,742
7,1,58,1170,747,423
7,1,59,947,1172,-225
7,1,61,1002,227,775
7,1,64,1198,769,429
7,1,65,1019,357,662
7,1,66,1094,433,661
7,1,67,1364,1332,32
7,1,68,1080,317,763
7,1,69,1052,33,1019
7,1,70,1148,339,809
7,1,71,943,1038,-95
7,1,72,930,179,751
8,2,1,848,940,-92
8,2,2,777,890,-113
8,2,3,738,822,-84
8,2,4,827,720,107
8,2,5,868,1098,-230
8,2,6,929,948,-19
8,2,7,931,837,94
8,2,8,816,906,-90
8,2,9,941,764,177
8,2,10,759,802,-43
8,2,11,824,713,111
8,2,12,870,1105,-235
8,2,13,865,781,84
8,2,14,876,674,202
8,2,15,770,742,28
8,2,16,739,715,24
8,2,18,863,783,80
8,2,19,857,771,86
8,2,20,748,773,-25
8,2,23,781,758,23
8,2,24,719,771,-52
8,2,25,846,667,179
8,2,26,764,772,-8
8,2,27,704,802,-98
8,2,28,740,794,-54
8,2,29,755,762,-7
8,2,30,737,690,47
8,2,31,783,723,60
8,2,32,771,837,-66
8,2,33,723,755,-32
8,2,34,791,777,14
8,2,35,800,796,4
8,2,36,759,731,28
8,2,37,816,684,132
8,2,38,714,743,-29
8,2,39,694,638,56
8,2,40,731,715,16
8,2,41,721,750,-29
8,2,42,696,678,18
8,2,43,806,875,-69
8,2,44,993,674,319
8,2,45,850,783,67
8,2,47,790,639,151
8,2,48,825,692,133
8,2,49,727,812,-85
8,2,50,772,720,52
8,2,51,736,740,-4
8,2,52,759,781,-22
8,2,53,753,792,-39
8,2,54,723,719,4
8,2,55,744,623,121
8,2,56,896,679,217
8,2,57,785,770,15
8,2,58,731,756,-25
8,2,59,856,944,-88
8,2,60,773,788,-15
8,2,61,764,712,52
8,2,62,701,808,-107
8,2,63,720,702,18
8,2,64,807,760,47
8,2,65,780,602,178
8,2,66,718,757,-39
8,2,67,690,657,33
8,2,69,724,713,11
8,2,70,686,641,45
8,2,71,731,662,69
8,2,72,682,715,-33
9,2,1,1004,1659,-655
9,2,2,1273,1154,119
9,2,3,1381,951,430
9,2,4,1002,1489,-487
9,2,5,1134,1139,-5
9,2,6,931,1357,-426
9,2,7,886,1123,-237
9,2,8,1523,1531,-8
9,2,9,1464,1240,224
9,2,11,889,1170,-281
9,2,12,990,1076,-86
9,2,13,948,1440,-492
9,2,14,989,1190,-201
9,2,16,1065,1408,-343
9,2,18,940,1255,-315
9,2,20,1004,1790,-786
9,2,21,1157,916,241
9,2,24,976,980,-4
9,2,25,1266,1123,143
9,2,26,1025,1370,-345
9,2,27,1024,986,38
9,2,28,1315,1256,59
9,2,31,870,1258,-388
9,2,32,1405,1374,31
9,2,33,1078,1048,30
9,2,34,1088,1021,67
9,2,35,1088,1646,-558
9,2,36,1423,1272,151
9,2,39,1162,1190,-28
9,2,40,923,1088,-165
9,2,41,1055,1120,-65
9,2,42,1107,1778,-671
9,2,43,1276,1074,202
9,2,44,1115,1048,67
9,2,45,1071,1087,-16
9,2,46,905,896,9
9,2,47,1041,922,119
9,2,48,993,953,40
9,2,49,906,1013,-107
9,2,50,945,843,102
9,2,51,1204,1138,66
9,2,52,944,904,40
9,2,53,1070,1085,-15
9,2,54,1116,1144,-28
9,2,55,1360,1110,250
9,2,56,1076,1563,-487
9,2,57,1087,1041,46
9,2,63,1400,1216,184
9,2,64,1409,1227,182
9,2,66,999,1056,-57
9,2,67,1085,1223,-138
9,2,68,1371,1016,355
9,2,69,1253,1372,-119
10,1,1,1029,1445,-416
10,1,2,912,862,50
10,1,4,1310,1018,292
10,1,5,856,828,28
10,1,6,824,808,16
10,1,7,969,512,457
10,1,8,901,431,470
10,1,9,1174,1118,56
10,1,10,966,1002,-36
10,1,11,985,1036,-51
10,1,12,914,948,-34
10,1,13,950,420,530
10,1,14,742,360,382
10,1,15,939,563,376
10,1,16,976,444,532
10,1,17,74,129,-55
10,1,18,990,397,593
10,1,19,687,328,359
10,1,20,689,207,482
10,1,21,806,716,90
10,1,22,824,1258,-434
10,1,23,1176,722,454
10,1,25,824,143,681
10,1,26,725,146,579
10,1,27,840,37,803
10,1,28,404,17,387
10,1,29,738,55,683
10,1,32,971,72,899
10,1,33,602,176,426
10,1,34,1228,106,1122
10,1,35,1002,62,940
10,1,36,927,221,706
10,1,37,889,100,789
10,1,38,853,384,469
10,1,40,931,74,857
10,1,41,830,163,667
10,1,42,727,203,524
10,1,43,670,470,200
10,1,44,846,6,840
10,1,45,714,14,700
10,1,46,911,566,345
10,1,47,961,114,847
10,1,48,814,560,254
10,1,49,1135,359,776
10,1,50,871,347,524
10,1,51,1030,259,771
10,1,52,1093,56,1037
10,1,53,855,484,371
10,1,54,932,119,813
10,1,55,817,32,785
10,1,56,901,85,816
10,1,58,1009,439,570
10,1,59,936,141,795
10,1,60,917,117,800
10,1,61,867,94,773
10,1,63,386,14,372
10,1,64,886,46,840
10,1,65,1026,24,1002
10,1,66,933,126,807
10,1,67,840,111,729
10,1,68,835,125,710
10,1,69,847,46,801
10,1,70,815,91,724
10,1,71,884,65,819
10,1,72,910,55,855
11,1,1,1275,1371,-96
11,1,2,1006,1250,-244
11,1,3,1071,1398,-327
11,1,4,1000,1109,-109
11,1,5,936,968,-32
11,1,6,1003,1100,-97
11,1,7,1023,1650,-627
11,1,8,938,1096,-158
11,1,9,1000,1083,-83
11,1,10,901,1041,-140
11,1,11,890,1049,-159
11,1,12,900,1081,-181
11,1,13,826,1095,-269
11,1,14,883,968,-85
11,1,15,1202,1307,-105
11,1,16,1216,1091,125
11,1,17,1783,1383,400
11,1,18,970,1032,-62
11,1,19,932,1032,-100
11,1,20,901,991,-90
11,1,21,924,1084,-160
11,1,22,1009,1124,-115
11,1,23,937,1048,-111
11,1,24,859,997,-138
11,1,25,990,1131,-141
11,1,26,1055,1116,-61
11,1,27,920,1005,-85
11,1,28,865,1025,-160
11,1,29,847,1119,-272
11,1,30,866,1110,-244
11,1,31,889,975,-86
11,1,32,896,1083,-187
11,1,33,916,1216,-300
11,1,34,773,885,-112
11,1,35,750,965,-215
11,1,36,849,1023,-174
11,1,37,820,1116,-296
11,1,38,852,1079,-227
11,1,40,805,954,-149
11,1,41,712,970,-258
11,1,42,873,1006,-133
11,1,43,721,1014,-293
11,1,44,773,931,-158
11,1,45,651,904,-253
11,1,46,860,951,-91
11,1,47,904,990,-86
11,1,48,742,951,-209
11,1,49,801,971,-170
11,1,50,687,864,-177
11,1,51,829,900,-71
11,1,52,818,934,-116
11,1,53,691,981,-290
11,1,54,894,965,-71
11,1,55,788,609,179
11,1,56,769,931,-162
11,1,57,771,949,-178
11,1,58,955,602,353
11,1,59,918,1005,-87
11,1,60,752,648,104
11,1,61,868,404,464
11,1,62,882,542,340
11,1,63,818,546,272
11,1,64,899,1272,-373
11,1,65,822,416,406
11,1,66,983,452,531
11,1,67,903,507,396
11,1,68,773,889,-116
11,1,69,858,372,486
11,1,70,691,383,308
11,1,71,882,1001,-119
11,1,72,843,976,-133
12,2,1,710,1265,-555
12,2,2,725,1055,-330
12,2,3,843,1012,-169
12,2,4,778,890,-112
12,2,5,800,891,-91
12,2,6,795,821,-26
12,2,7,779,748,31
12,2,8,744,835,-91
12,2,9,766,1030,-264
12,2,10,735,827,-92
12,2,11,672,795,-123
12,2,13,680,817,-137
12,2,14,775,1162,-387
12,2,15,832,1041,-209
12,2,16,742,815,-73
12,2,17,791,920,-129
12,2,18,867,854,13
12,2,19,793,779,14
12,2,20,828,920,-92
12,2,21,756,918,-162
12,2,22,771,926,-155
12,2,23,599,697,-98
12,2,25,863,744,119
12,2,26,855,1145,-290
12,2,27,765,849,-84
12,2,28,781,1167,-386
12,2,29,790,928,-138
12,2,30,821,896,-75
12,2,31,653,807,-154
12,2,32,833,885,-52
12,2,33,661,752,-91
12,2,34,765,871,-106
12,2,35,767,747,20
12,2,36,854,800,54
12,2,37,705,773,-68
12,2,38,642,756,-114
12,2,39,720,123,597
12,2,40,752,792,-40
12,2,41,665,436,229
12,2,42,681,60,621
12,2,43,637,462,175
12,2,45,786,92,694
12,2,47,716,133,583
12,2,48,631,75,556
12,2,49,942,352,590
12,2,50,733,31,702
12,2,51,628,277,351
12,2,52,687,362,325
12,2,53,909,23,886
12,2,55,603,491,112
12,2,56,744,447,297
12,2,57,572,500,72
12,2,58,670,40,630
12,2,59,657,25,632
12,2,60,594,150,444
12,2,61,634,237,397
12,2,62,714,58,656
12,2,63,761,98,663
12,2,64,589,141,448
12,2,65,1377,324,1053
12,2,66,717,873,-156
12,2,67,777,67,710
12,2,68,769,771,-2
12,2,70,745,42,703
12,2,71,631,66,565
12,2,72,656,3,653
13,1,1,975,1976,-1001
13,1,2,881,1344,-463
13,1,3,928,1031,-103
13,1,4,843,868,-25
13,1,5,897,946,-49
13,1,6,887,958,-71
13,1,7,1151,1189,-38
13,1,8,936,1094,-158
13,1,9,1013,1058,-45
13,1,10,1068,1131,-63
13,1,11,1202,1431,-229
13,1,12,1071,1236,-165
13,1,13,1293,1656,-363
13,1,14,1028,1176,-148
13,1,15,1209,1348,-139
13,1,16,1143,1416,-273
13,1,17,1212,1573,-361
13,1,18,1408,1205,203
13,1,19,1282,1444,-162
13,1,20,1310,1526,-216
13,1,22,1158,1084,74
13,1,23,1082,1524,-442
13,1,24,1276,1206,70
13,1,25,1253,1583,-330
13,1,26,1131,1294,-163
13,1,28,1045,1309,-264
13,1,29,1442,1917,-475
13,1,31,1292,1049,243
13,1,32,1135,1325,-190
13,1,33,1064,1114,-50
13,1,34,1574,1604,-30
13,1,36,1374,1022,352
13,1,37,1149,1029,120
13,1,38,1053,1145,-92
13,1,39,1430,1286,144
13,1,40,1381,1459,-78
13,1,41,1413,1485,-72
13,1,42,1109,1069,40
13,1,43,1735,1168,567
13,1,44,1832,1470,362
13,1,45,1162,1239,-77
13,1,46,1080,1074,6
13,1,47,906,802,104
13,1,48,806,761,45
13,1,49,1290,716,574
13,1,50,863,994,-131
13,1,51,1007,1070,-63
13,1,52,1177,1011,166
13,1,53,988,995,-7
13,1,54,1071,1097,-26
13,1,55,1110,1141,-31
13,1,56,914,1140,-226
13,1,57,953,1483,-530
13,1,58,841,1026,-185
13,1,59,956,1442,-486
13,1,60,1105,1113,-8
13,1,61,952,1092,-140
13,1,62,952,1114,-162
13,1,63,1073,1042,31
13,1,64,1011,980,31
13,1,65,1073,1162,-89
13,1,66,1381,1135,246
13,1,67,1161,1039,122
13,1,68,1210,1025,185
13,1,69,1015,619,396
13,1,71,971,1038,-67
13,1,72,920,1042,-122
14,3,1,921,1155,-234
14,3,2,1004,879,125
14,3,3,872,847,25
14,3,4,813,992,-179
14,3,5,887,977,-90
14,3,6,939,715,224
14,3,7,1007,1023,-16
14,3,8,1183,1152,31
14,3,9,1032,732,300
14,3,10,982,1205,-223
14,3,11,1154,1039,115
14,3,12,1006,1080,-74
14,3,13,1408,1038,370
14,3,15,962,1235,-273
14,3,16,1171,824,347
14,3,17,910,896,14
14,3,18,961,898,63
14,3,19,1180,949,231
14,3,21,1036,911,125
14,3,22,1184,1387,-203
14,3,23,1075,965,110
14,3,24,1259,1285,-26
14,3,25,1350,822,528
14,3,26,1099,997,102
14,3,27,939,1049,-110
14,3,28,982,1032,-50
14,3,29,1194,1295,-101
14,3,30,974,1139,-165
14,3,31,995,910,85
14,3,32,1157,1013,144
14,3,33,1176,958,218
14,3,34,995,955,40
14,3,35,986,985,1
14,3,36,969,941,28
14,3,37,914,1173,-259
14,3,38,1155,1088,67
14,3,39,1231,1118,113
14,3,40,943,844,99
14,3,41,1037,1157,-120
14,3,42,933,1006,-73
14,3,43,995,864,131
14,3,44,912,950,-38
14,3,46,1156,1083,73
14,3,47,1371,975,396
14,3,48,905,1012,-107
14,3,49,996,917,79
14,3,50,839,828,11
14,3,51,1011,664,347
14,3,52,851,832,19
14,3,53,892,741,151
14,3,54,1016,674,342
14,3,55,1063,728,335
14,3,56,847,878,-31
14,3,57,927,691,236
14,3,58,925,1008,-83
14,3,59,1008,947,61
14,3,60,1008,774,234
14,3,61,1062,962,100
14,3,62,1090,868,222
14,3,63,1365,1412,-47
14,3,64,920,725,195
14,3,65,1073,837,236
14,3,66,956,881,75
14,3,67,1171,976,195
14,3,68,990,764,226
14,3,69,1017,697,320
14,3,70,928,709,219
14,3,71,868,620,248
14,3,72,878,714,164
15,1,1,1116,1195,-79
15,1,2,1013,1219,-206
15,1,3,1047,1116,-69
15,1,4,818,1035,-217
15,1,5,988,1121,-133
15,1,6,911,936,-25
15,1,7,890,1307,-417
15,1,8,874,882,-8
15,1,9,848,1006,-158
15,1,10,984,921,63
15,1,11,962,923,39
15,1,12,919,1003,-84
15,1,13,879,1014,-135
15,1,14,1694,1275,419
15,1,15,970,914,56
15,1,16,913,834,79
15,1,17,816,908,-92
15,1,18,839,959,-120
15,1,19,911,940,-29
15,1,20,981,1371,-390
15,1,21,1120,979,141
15,1,22,884,1108,-224
15,1,23,833,961,-128
15,1,25,920,888,32
15,1,26,895,800,95
15,1,27,909,907,2
15,1,28,895,1023,-128
15,1,29,877,993,-116
15,1,30,763,831,-68
15,1,31,818,939,-121
15,1,32,890,990,-100
15,1,33,935,907,28
15,1,34,874,1102,-228
15,1,35,977,1082,-105
15,1,36,933,993,-60
15,1,38,1003,1075,-72
15,1,40,828,968,-140
15,1,41,820,1481,-661
15,1,42,1018,966,52
15,1,43,892,959,-67
15,1,44,970,1119,-149
15,1,45,863,943,-80
15,1,46,875,860,15
15,1,47,930,851,79
15,1,48,816,1032,-216
15,1,49,897,935,-38
15,1,50,772,957,-185
15,1,51,1009,904,105
15,1,52,772,823,-51
15,1,53,1205,1013,192
15,1,54,804,859,-55
15,1,55,917,1062,-145
15,1,56,894,895,-1
15,1,57,848,963,-115
15,1,58,896,942,-46
15,1,59,878,1425,-547
15,1,60,1017,1118,-101
15,1,61,880,1192,-312
15,1,62,824,914,-90
15,1,63,844,932,-88
15,1,64,838,874,-36
15,1,66,991,1083,-92
15,1,67,939,941,-2
15,1,68,902,1054,-152
15,1,69,905,845,60
15,1,70,945,1520,-575
15,1,71,812,931,-119
15,1,72,835,928,-93
16,2,1,936,1686,-750
16,2,2,966,1383,-417
16,2,3,873,1349,-476
16,2,4,915,1164,-249
16,2,5,927,1100,-173
16,2,6,1085,1123,-38
16,2,7,869,848,21
16,2,8,861,1222,-361
16,2,10,843,881,-38
16,2,11,885,886,-1
16,2,12,921,931,-10
16,2,14,899,960,-61
16,2,15,805,948,-143
16,2,16,906,947,-41
16,2,17,873,906,-33
16,2,18,883,949,-66
16,2,19,801,916,-115
16,2,20,850,889,-39
16,2,21,776,834,-58
16,2,22,807,874,-67
16,2,23,847,864,-17
16,2,24,818,860,-42
16,2,25,806,878,-72
16,2,26,832,924,-92
16,2,27,788,851,-63
16,2,28,898,919,-21
16,2,29,862,948,-86
16,2,30,812,835,-23
16,2,31,900,1037,-137
16,2,32,842,1842,-1000
16,2,34,832,1061,-229
16,2,35,859,1039,-180
16,2,37,1451,1284,167
16,2,38,864,1295,-431
16,2,39,858,1247,-389
16,2,41,925,1364,-439
16,2,42,1002,1092,-90
16,2,43,904,931,-27
16,2,44,881,1090,-209
16,2,45,952,890,62
16,2,46,822,1707,-885
16,2,47,903,1119,-216
16,2,48,879,1333,-454
16,2,49,890,1579,-689
16,2,50,912,1147,-235
16,2,51,900,948,-48
16,2,53,950,999,-49
16,2,54,816,1680,-864
16,2,56,884,1083,-199
16,2,57,859,936,-77
16,2,58,856,1387,-531
16,2,59,1023,1247,-224
16,2,60,1117,1184,-67
16,2,61,904,1184,-280
16,2,62,883,1225,-342
16,2,63,896,1209,-313
16,2,64,862,1168,-306
16,2,65,870,1149,-279
16,2,66,924,1100,-176
16,2,67,862,1269,-407
16,2,68,908,1138,-230
16,2,69,853,1079,-226
16,2,70,898,1360,-462
16,2,71,809,1098,-289
16,2,72,932,1113,-181
17,3,1,1092,1477,-385
17,3,2,1188,1217,-29
17,3,3,925,1153,-228
17,3,5,893,1283,-390
17,3,6,1097,1101,-4
17,3,7,931,1327,-396
17,3,8,851,1020,-169
17,3,9,868,1195,-327
17,3,10,883,1039,-156
17,3,12,1080,1074,6
17,3,13,982,1018,-36
17,3,14,967,1031,-64
17,3,15,1152,1020,132
17,3,16,890,973,-83
17,3,17,1080,1066,14
17,3,18,1003,1132,-129
17,3,19,1228,1158,70
17,3,20,1065,1123,-58
17,3,21,1189,953,236
17,3,22,1049,1303,-254
17,3,23,1090,1209,-119
17,3,24,1122,1187,-65
17,3,25,1134,1033,101
17,3,26,1056,1220,-164
17,3,27,1184,1052,132
17,3,28,1156,1054,102
17,3,29,1076,1287,-211
17,3,30,1085,1125,-40
17,3,31,990,979,11
17,3,32,1441,1168,273
17,3,33,931,1134,-203
17,3,34,948,1159,-211
17,3,35,1329,1307,22
17,3,36,1239,1286,-47
17,3,37,1653,1065,588
17,3,38,1105,1348,-243
17,3,39,983,1115,-132
17,3,40,1729,1068,661
17,3,41,1092,1049,43
17,3,42,951,979,-28
17,3,43,1404,1000,404
17,3,45,1230,1297,-67
17,3,46,1145,1508,-363
17,3,47,1039,1249,-210
17,3,48,1104,1292,-188
17,3,49,1324,1241,83
17,3,50,1081,949,132
17,3,51,1113,1295,-182
17,3,52,1025,1667,-642
17,3,53,1018,1141,-123
17,3,54,1050,1060,-10
17,3,55,1098,1044,54
17,3,56,1015,1315,-300
17,3,57,1032,1202,-170
17,3,58,1018,1120,-102
17,3,59,1102,1145,-43
17,3,60,1040,1150,-110
17,3,61,1312,1648,-336
17,3,62,1111,1067,44
17,3,63,1016,1072,-56
17,3,64,991,1302,-311
17,3,65,1145,1556,-411
17,3,66,1048,1336,-288
17,3,67,1063,1372,-309
17,3,68,1069,1250,-181
17,3,69,1106,1299,-193
17,3,70,1049,1301,-252
17,3,71,1080,1547,-467
17,3,72,1110,1225,-115
18,3,1,842,991,-149
18,3,2,960,929,31
18,3,3,961,843,118
18,3,4,793,915,-122
18,3,5,839,810,29
18,3,6,755,732,23
18,3,7,898,746,152
18,3,9,885,1266,-381
18,3,10,1002,709,293
18,3,11,856,1364,-508
18,3,12,794,770,24
18,3,13,787,891,-104
18,3,14,774,843,-69
18,3,15,808,724,84
18,3,16,773,732,41
18,3,17,828,794,34
18,3,18,747,789,-42
18,3,20,784,840,-56
18,3,21,706,707,-1
18,3,22,887,777,110
18,3,23,810,760,50
18,3,24,746,816,-70
18,3,25,734,838,-104
18,3,26,755,890,-135
18,3,27,719,673,46
18,3,28,860,871,-11
18,3,30,789,730,59
18,3,31,786,721,65
18,3,32,765,648,117
18,3,33,832,718,114
18,3,34,805,769,36
18,3,35,786,769,17
18,3,36,688,717,-29
18,3,37,708,791,-83
18,3,38,688,738,-50
18,3,39,798,1093,-295
18,3,40,715,728,-13
18,3,41,820,753,67
18,3,42,822,723,99
18,3,43,776,886,-110
18,3,44,798,699,99
18,3,45,859,746,113
18,3,46,781,708,73
18,3,47,722,727,-5
18,3,48,770,748,22
18,3,49,1143,1093,50
18,3,51,822,730,92
18,3,52,792,697,95
18,3,53,1054,790,264
18,3,54,764,648,116
18,3,55,721,521,200
18,3,56,761,671,90
18,3,58,703,710,-7
18,3,59,757,703,54
18,3,60,761,662,99
18,3,61,969,661,308
18,3,62,743,748,-5
18,3,63,757,707,50
18,3,65,745,765,-20
18,3,66,739,706,33
18,3,67,798,661,137
18,3,68,750,393,357
18,3,69,661,51,610
18,3,70,676,316,360
18,3,72,727,323,404
19,1,1,1041,1336,-295
19,1,2,1081,1191,-110
19,1,3,1095,1004,91
19,1,4,960,1012,-52
19,1,5,1132,1089,43
19,1,6,1123,1156,-33
19,1,7,1022,1058,-36
19,1,8,960,1095,-135
19,1,9,1037,1373,-336
19,1,10,1018,1045,-27
19,1,11,956,994,-38
19,1,12,993,1022,-29
19,1,13,910,1018,-108
19,1,14,926,1004,-78
19,1,15,931,1049,-118
19,1,16,887,1139,-252
19,1,17,938,1078,-140
19,1,18,1003,997,6
19,1,19,1084,1120,-36
19,1,20,887,1045,-158
19,1,21,1030,1049,-19
19,1,22,886,1066,-180
19,1,23,973,1141,-168
19,1,24,1012,1258,-246
19,1,25,935,998,-63
19,1,26,996,1028,-32
19,1,27,961,1099,-138
19,1,28,1075,1099,-24
19,1,29,963,1050,-87
19,1,30,954,1120,-166
19,1,31,947,1144,-197
19,1,32,922,1118,-196
19,1,33,969,1159,-190
19,1,34,967,1289,-322
19,1,35,970,1135,-165
19,1,36,959,1162,-203
19,1,37,1055,1282,-227
19,1,38,995,967,28
19,1,39,1047,1179,-132
19,1,40,924,963,-39
19,1,41,834,993,-159
19,1,42,663,271,392
19,1,43,846,1052,-206
19,1,44,833,960,-127
19,1,45,860,1018,-158
19,1,46,941,536,405
19,1,47,831,979,-148
19,1,48,884,1027,-143
19,1,49,890,1057,-167
19,1,50,799,456,343
19,1,51,854,407,447
19,1,52,890,449,441
19,1,53,900,433,467
19,1,54,940,372,568
19,1,55,941,367,574
19,1,56,1079,273,806
19,1,57,869,411,458
19,1,58,941,376,565
19,1,59,971,458,513
19,1,60,887,506,381
19,1,61,892,314,578
19,1,62,916,430,486
19,1,63,928,425,503
19,1,64,1036,759,277
19,1,65,848,633,215
19,1,66,880,420,460
19,1,67,867,852,15
19,1,68,922,344,578
19,1,69,1111,418,693
19,1,70,851,460,391
19,1,71,837,398,439
19,1,72,1004,426,578
20,2,1,853,964,-111
20,2,2,831,894,-63
20,2,3,838,817,21
20,2,4,1241,787,454
20,2,5,696,761,-65
20,2,6,1197,697,500
20,2,7,714,870,-156
20,2,8,730,726,4
20,2,9,838,747,91
20,2,10,752,761,-9
20,2,11,737,1412,-675
20,2,12,750,691,59
20,2,13,759,898,-139
20,2,14,734,768,-34
20,2,15,815,769,46
20,2,16,756,748,8
20,2,17,774,771,3
20,2,18,802,821,-19
20,2,19,713,691,22
20,2,20,694,734,-40
20,2,21,719,732,-13
20,2,22,822,706,116
20,2,23,799,777,22
20,2,24,748,855,-107
20,2,25,732,776,-44
20,2,26,781,850,-69
20,2,27,779,980,-201
20,2,28,693,687,6
20,2,29,728,749,-21
20,2,30,735,679,56
20,2,31,700,720,-20
20,2,32,733,719,14
20,2,33,739,766,-27
20,2,35,736,776,-40
20,2,36,746,986,-240
20,2,37,777,735,42
20,2,38,822,789,33
20,2,39,1329,756,573
20,2,40,669,1042,-373
20,2,41,1132,832,300
20,2,42,1293,1662,-369
20,2,43,702,733,-31
20,2,44,680,671,9
20,2,45,842,858,-16
20,2,46,695,742,-47
20,2,47,685,783,-98
20,2,48,721,776,-55
20,2,49,759,724,35
20,2,50,757,717,40
20,2,51,768,713,55
20,2,52,716,787,-71
20,2,53,1041,699,342
20,2,54,752,822,-70
20,2,55,768,716,52
20,2,56,1004,1581,-577
20,2,57,714,812,-98
20,2,58,804,1553,-749
20,2,59,995,1053,-58
20,2,60,1666,1024,642
20,2,61,1373,817,556
20,2,62,857,834,23
20,2,63,700,695,5
20,2,64,726,775,-49
20,2,65,917,1044,-127
20,2,66,794,717,77
20,2,67,722,817,-95
20,2,68,746,768,-22
20,2,69,768,759,9
20,2,70,738,877,-139
20,2,71,1043,689,354
20,2,72,746,812,-66
21,1,1,957,1046,-89
21,1,2,845,915,-70
21,1,3,827,760,67
21,1,4,1027,890,137
21,1,6,908,792,116
21,1,7,806,722,84
21,1,8,843,870,-27
21,1,9,592,355,237
21,1,10,593,353,240
21,1,11,798,355,443
21,1,12,687,509,178
21,1,13,715,368,347
21,1,14,827,193,634
21,1,15,553,331,222
21,1,16,862,316,546
21,1,17,787,175,612
21,1,18,580,298,282
21,1,19,783,95,688
21,1,20,853,293,560
21,1,21,660,370,290
21,1,22,886,188,698
21,1,23,752,157,595
21,1,24,826,140,686
21,1,25,720,321,399
21,1,27,785,398,387
21,1,28,992,578,414
21,1,29,1032,402,630
21,1,30,805,200,605
21,1,31,768,305,463
21,1,32,580,410,170
21,1,33,767,303,464
21,1,34,828,348,480
21,1,35,823,415,408
21,1,36,847,570,277
21,1,37,795,310,485
21,1,38,833,440,393
21,1,39,895,177,718
21,1,40,773,33,740
21,1,41,768,385,383
21,1,42,743,348,395
21,1,43,875,505,370
21,1,44,1178,40,1138
21,1,45,793,471,322
21,1,46,725,368,357
21,1,47,865,85,780
21,1,48,817,245,572
21,1,49,902,315,587
21,1,50,757,447,310
21,1,51,698,385,313
21,1,52,825,37,788
21,1,53,715,87,628
21,1,54,643,60,583
21,1,55,878,188,690
21,1,56,643,290,353
21,1,57,790,47,743
21,1,58,697,27,670
21,1,59,838,640,198
21,1,60,825,145,680
21,1,61,803,425,378
21,1,62,745,360,385
21,1,63,825,192,633
21,1,64,918,65,853
21,1,65,775,442,333
21,1,66,735,72,663
21,1,67,809,337,472
21,1,68,763,480,283
21,1,69,695,405,290
21,1,70,750,412,338
21,1,71,735,407,328
21,1,72,930,575,355
22,3,1,1172,1636,-464
22,3,2,1288,1156,132
22,3,3,1024,1118,-94
22,3,4,974,1127,-153
22,3,5,1035,976,59
22,3,6,1072,998,74
22,3,7,1239,1099,140
22,3,8,949,1145,-196
22,3,9,1074,1039,35
22,3,10,1072,1101,-29
22,3,11,982,1389,-407
22,3,12,1123,1015,108
22,3,13,969,927,42
22,3,14,857,1198,-341
22,3,15,1185,1032,153
22,3,16,1051,1163,-112
22,3,17,938,943,-5
22,3,18,970,1120,-150
22,3,19,952,970,-18
22,3,20,996,1082,-86
22,3,21,1006,874,132
22,3,22,1028,1062,-34
22,3,23,978,957,21
22,3,24,1013,1056,-43
22,3,25,913,1201,-288
22,3,26,900,1177,-277
22,3,27,1136,1170,-34
22,3,28,1342,1106,236
22,3,29,991,1101,-110
22,3,30,989,1110,-121
22,3,31,1073,1030,43
22,3,32,1045,1113,-68
22,3,33,1002,994,8
22,3,34,1061,1151,-90
22,3,35,922,1014,-92
22,3,36,906,1076,-170
22,3,37,1241,928,313
22,3,38,1015,1099,-84
22,3,39,875,976,-101
22,3,40,1000,966,34
22,3,41,1789,1123,666
22,3,42,1039,1292,-253
22,3,43,929,1014,-85
22,3,44,938,1089,-151
22,3,45,1043,1238,-195
22,3,46,951,1114,-163
22,3,47,953,1021,-68
22,3,48,867,1022,-155
22,3,49,968,1139,-171
22,3,50,910,891,19
22,3,51,1015,1029,-14
22,3,52,1005,1032,-27
22,3,53,963,1155,-192
22,3,54,970,1016,-46
22,3,55,1095,1162,-67
22,3,56,1130,1090,40
22,3,57,956,1188,-232
22,3,58,1114,1302,-188
22,3,59,1071,1205,-134
22,3,60,1023,1257,-234
22,3,61,950,1157,-207
22,3,62,1008,1115,-107
22,3,63,1107,939,168
22,3,64,1507,1420,87
22,3,66,1097,1394,-297
22,3,67,1247,1063,184
22,3,68,1046,1135,-89
22,3,69,1041,1142,-101
22,3,70,1104,1346,-242
22,3,71,1131,1221,-90
22,3,72,1154,1099,55
23,3,1,841,1198,-357
23,3,2,855,977,-122
23,3,3,810,1012,-202
23,3,4,855,912,-57
23,3,5,848,1012,-164
23,3,6,787,926,-139
23,3,7,896,872,24
23,3,8,866,959,-93
23,3,9,1673,902,771
23,3,10,800,1064,-264
23,3,11,828,910,-82
23,3,12,997,1941,-944
23,3,13,755,879,-124
23,3,14,747,858,-111
23,3,15,745,827,-82
23,3,16,854,802,52
23,3,17,835,806,29
23,3,18,804,794,10
23,3,19,823,814,9
23,3,20,836,834,2
23,3,21,875,786,89
23,3,23,788,811,-23
23,3,25,1371,782,589
23,3,26,846,1099,-253
23,3,27,824,1038,-214
23,3,28,813,858,-45
23,3,29,796,818,-22
23,3,31,766,918,-152
23,3,32,839,952,-113
23,3,33,769,856,-87
23,3,34,784,1061,-277
23,3,35,1320,749,571
23,3,36,908,791,117
23,3,37,943,794,149
23,3,38,785,844,-59
23,3,39,830,848,-18
23,3,40,705,964,-259
23,3,41,895,758,137
23,3,42,848,927,-79
23,3,43,845,920,-75
23,3,44,779,880,-101
23,3,45,845,1046,-201
23,3,46,759,980,-221
23,3,47,932,894,38
23,3,48,706,829,-123
23,3,49,779,835,-56
23,3,50,761,847,-86
23,3,51,811,859,-48
23,3,52,799,809,-10
23,3,53,790,917,-127
23,3,54,810,985,-175
23,3,55,848,952,-104
23,3,56,782,891,-109
23,3,57,772,832,-60
23,3,58,767,855,-88
23,3,59,820,1202,-382
23,3,60,800,901,-101
23,3,61,1035,753,282
23,3,62,845,836,9
23,3,63,774,738,36
23,3,64,708,805,-97
23,3,65,732,1070,-338
23,3,66,1886,1164,722
23,3,67,1061,905,156
23,3,68,949,1326,-377
23,3,69,921,977,-56
23,3,70,984,1077,-93
23,3,71,1085,962,123
23,3,72,1358,1185,173
24,3,1,1524,1038,486
24,3,2,1101,1086,15
24,3,3,900,917,-17
24,3,4,1529,1010,519
24,3,5,1090,923,167
24,3,6,1204,1208,-4
24,3,7,1029,836,193
24,3,8,1114,1073,41
24,3,9,1048,862,186
24,3,10,982,916,66
24,3,12,951,933,18
24,3,13,858,939,-81
24,3,14,754,696,58
24,3,15,946,964,-18
24,3,16,791,744,47
24,3,17,1332,1157,175
24,3,18,1616,1657,-41
24,3,20,1453,852,601
24,3,22,966,846,120
24,3,23,1023,787,236
24,3,25,1000,880,120
24,3,27,1006,825,181
24,3,28,1037,880,157
24,3,29,909,805,104
24,3,30,886,975,-89
24,3,34,937,936,1
24,3,43,1000,1167,-167
24,3,44,860,710,150
24,3,45,948,829,119
24,3,49,874,826,48
24,3,50,1069,1065,4
24,3,51,1061,919,142
24,3,52,1071,933,138
24,3,53,992,984,8
24,3,54,1069,822,247
24,3,55,977,842,135
24,3,60,1352,1185,167
24,3,62,1431,928,503
24,3,63,902,943,-41
24,3,64,938,935,3
24,3,66,1156,964,192
24,3,69,898,866,32
24,3,72,1249,1039,210
25,1,1,863,1284,-421
25,1,2,865,1071,-206
25,1,3,896,1061,-165
25,1,4,896,1077,-181
25,1,5,789,1091,-302
25,1,6,885,994,-109
25,1,7,754,767,-13
25,1,8,703,861,-158
25,1,9,792,844,-52
25,1,10,1083,561,522
25,1,12,966,1012,-46
25,1,13,1791,621,1170
25,1,14,929,663,266
25,1,15,897,766,131
25,1,16,751,380,371
25,1,17,812,705,107
25,1,18,974,698,276
25,1,19,774,756,18
25,1,20,729,669,60
25,1,21,684,274,410
25,1,22,674,377,297
25,1,23,789,466,323
25,1,24,929,407,522
25,1,25,843,832,11
25,1,26,725,826,-101
25,1,27,774,117,657
25,1,28,808,117,691
25,1,29,825,104,721
25,1,30,800,14,786
25,1,31,755,55,700
25,1,32,777,118,659
25,1,33,814,75,739
25,1,34,725,122,603
25,1,35,744,20,724
25,1,36,730,8,722
25,1,37,704,31,673
25,1,38,766,16,750
25,1,39,748,28,720
25,1,40,1190,292,898
25,1,41,753,518,235
25,1,42,854,12,842
25,1,43,752,18,734
25,1,44,813,5,808
25,1,45,805,18,787
25,1,46,645,21,624
25,1,47,800,16,784
25,1,48,727,112,615
25,1,49,630,2,628
25,1,50,797,15,782
25,1,51,762,6,756
25,1,52,706,32,674
25,1,53,700,19,681
25,1,54,904,1,903
25,1,55,760,22,738
25,1,56,744,395,349
25,1,58,599,9,590
25,1,59,722,23,699
25,1,60,637,25,612
25,1,61,1084,321,763
25,1,63,719,5,714
25,1,64,728,22,706
25,1,65,758,56,702
25,1,66,763,374,389
25,1,67,682,19,663
25,1,68,820,2,818
25,1,69,559,30,529
25,1,70,688,7,681
25,1,71,766,25,741
25,1,72,707,938,-231
26,3,1,972,1290,-318
26,3,2,949,1200,-251
26,3,3,1188,1556,-368
26,3,4,1044,1292,-248
26,3,5,1108,1200,-92
26,3,6,936,1188,-252
26,3,7,1036,1088,-52
26,3,8,948,1688,-740
26,3,9,916,1704,-788
26,3,10,1407,1063,344
26,3,11,1172,1096,76
26,3,12,1164,1040,124
26,3,13,821,1423,-602
26,3,15,1096,1026,70
26,3,16,972,1008,-36
26,3,17,1104,1092,12
26,3,18,956,1134,-178
26,3,19,924,1196,-272
26,3,20,966,1052,-86
26,3,21,1083,952,131
26,3,22,972,1287,-315
26,3,23,892,1133,-241
26,3,25,884,1088,-204
26,3,27,1044,1016,28
26,3,29,796,988,-192
26,3,30,912,1308,-396
26,3,31,924,1072,-148
26,3,32,708,916,-208
26,3,33,1124,825,299
26,3,34,1052,1008,44
26,3,35,988,956,32
26,3,36,850,1325,-475
26,3,37,912,920,-8
26,3,38,852,1469,-617
26,3,39,880,993,-113
26,3,40,996,1040,-44
26,3,41,864,1212,-348
26,3,42,1000,1108,-108
26,3,43,920,980,-60
26,3,44,820,1152,-332
26,3,45,936,1068,-132
26,3,46,1032,1128,-96
26,3,47,1092,948,144
26,3,48,996,992,4
26,3,49,828,820,8
26,3,50,956,968,-12
26,3,51,788,1124,-336
26,3,52,907,1092,-185
26,3,53,892,984,-92
26,3,54,944,932,12
26,3,55,925,1012,-87
26,3,56,949,1078,-129
26,3,57,820,1281,-461
26,3,58,927,1044,-117
26,3,59,940,984,-44
26,3,60,728,1021,-293
26,3,61,856,932,-76
26,3,62,1167,1053,114
26,3,63,752,1010,-258
26,3,64,941,968,-27
26,3,65,876,1098,-222
26,3,66,1017,1444,-427
26,3,67,1072,1256,-184
26,3,68,896,1144,-248
26,3,69,1096,1048,48
26,3,70,960,1200,-240
26,3,71,777,1145,-368
26,3,72,840,1408,-568
27,2,1,890,1491,-601
27,2,2,893,1091,-198
27,2,3,983,1071,-88
27,2,4,948,824,124
27,2,5,870,752,118
27,2,6,919,1199,-280
27,2,7,861,943,-82
27,2,8,935,942,-7
27,2,9,862,876,-14
27,2,10,844,884,-40
27,2,11,814,967,-153
27,2,12,784,779,5
27,2,13,794,945,-151
27,2,14,764,870,-106
27,2,15,991,794,197
27,2,16,822,868,-46
27,2,17,819,789,30
27,2,18,872,786,86
27,2,19,990,810,180
27,2,20,857,829,28
27,2,21,874,771,103
27,2,22,1098,796,302
27,2,23,911,795,116
27,2,24,937,734,203
27,2,25,1480,1329,151
27,2,26,841,817,24
27,2,28,775,827,-52
27,2,29,813,817,-4
27,2,30,808,999,-191
27,2,31,920,935,-15
27,2,32,828,805,23
27,2,33,854,823,31
27,2,34,887,867,20
27,2,35,780,792,-12
27,2,36,808,877,-69
27,2,37,913,782,131
27,2,38,790,870,-80
27,2,39,737,752,-15
27,2,40,809,708,101
27,2,41,904,767,137
27,2,42,946,731,215
27,2,43,752,782,-30
27,2,44,774,916,-142
27,2,45,1445,681,764
27,2,46,1129,1023,106
27,2,47,773,727,46
27,2,48,802,716,86
27,2,50,1014,891,123
27,2,51,742,821,-79
27,2,52,798,980,-182
27,2,53,891,792,99
27,2,54,729,683,46
27,2,55,774,1302,-528
27,2,56,883,751,132
27,2,57,782,754,28
27,2,58,765,724,41
27,2,59,747,830,-83
27,2,60,767,777,-10
27,2,61,758,774,-16
27,2,62,717,737,-20
27,2,63,748,894,-146
27,2,64,835,781,54
27,2,65,817,893,-76
27,2,66,782,828,-46
27,2,67,879,739,140
27,2,68,742,726,16
27,2,69,747,788,-41
27,2,70,732,730,2
27,2,71,728,699,29
27,2,72,709,690,19
28,3,1,1043,1343,-300
28,3,2,927,1193,-266
28,3,3,882,1168,-286
28,3,4,905,921,-16
28,3,5,906,1090,-184
28,3,6,955,993,-38
28,3,7,902,1018,-116
28,3,8,965,896,69
28,3,9,998,1084,-86
28,3,10,769,827,-58
28,3,11,916,1042,-126
28,3,12,1047,1280,-233
28,3,13,838,909,-71
28,3,14,854,760,94
28,3,15,909,841,68
28,3,16,820,816,4
28,3,17,921,904,17
28,3,18,943,1080,-137
28,3,19,993,880,113
28,3,20,908,1188,-280
28,3,21,793,727,66
28,3,22,878,944,-66
28,3,23,941,993,-52
28,3,24,844,887,-43
28,3,25,872,945,-73
28,3,26,810,1033,-223
28,3,27,1053,1075,-22
28,3,28,920,1027,-107
28,3,29,947,939,8
28,3,30,827,789,38
28,3,31,691,889,-198
28,3,32,739,775,-36
28,3,33,891,1028,-137
28,3,34,707,843,-136
28,3,36,970,760,210
28,3,38,832,784,48
28,3,39,771,412,359
28,3,41,994,368,626
28,3,42,821,328,493
28,3,43,933,340,593
28,3,44,1414,224,1190
28,3,45,772,40,732
28,3,47,754,155,599
28,3,48,754,108,646
28,3,49,1199,157,1042
28,3,50,828,279,549
28,3,51,896,1200,-304
28,3,52,965,89,876
28,3,53,793,455,338
28,3,54,821,1006,-185
28,3,55,677,349,328
28,3,56,874,684,190
28,3,57,1004,306,698
28,3,58,922,142,780
28,3,59,793,122,671
28,3,60,835,176,659
28,3,61,836,306,530
28,3,62,880,171,709
28,3,63,773,326,447
28,3,64,969,24,945
28,3,65,831,347,484
28,3,66,1048,338,710
28,3,67,940,977,-37
28,3,68,997,343,654
28,3,69,903,142,761
28,3,70,914,394,520
28,3,71,964,304,660
28,3,72,827,33,794
29,2,1,1099,1103,-4
29,2,2,1040,1037,3
29,2,3,1003,1022,-19
29,2,4,936,948,-12
29,2,5,1046,1106,-60
29,2,6,1077,905,172
29,2,7,1001,958,43
29,2,8,1104,1286,-182
29,2,9,929,959,-30
29,2,10,944,1057,-113
29,2,11,979,938,41
29,2,12,1001,1234,-233
29,2,13,1301,1064,237
29,2,14,902,829,73
29,2,15,813,862,-49
29,2,16,940,904,36
29,2,17,933,1125,-192
29,2,18,912,1257,-345
29,2,19,921,959,-38
29,2,20,975,1047,-72
29,2,21,1201,955,246
29,2,23,940,1610,-670
29,2,24,1018,942,76
29,2,25,1025,903,122
29,2,26,1004,887,117
29,2,27,861,943,-82
29,2,28,887,1656,-769
29,2,29,1018,929,89
29,2,30,830,779,51
29,2,31,838,951,-113
29,2,32,942,985,-43
29,2,33,797,769,28
29,2,34,1051,903,148
29,2,35,1089,1025,64
29,2,36,916,980,-64
29,2,37,921,926,-5
29,2,38,906,907,-1
29,2,39,833,1003,-170
29,2,40,857,751,106
29,2,41,882,1342,-460
29,2,42,864,954,-90
29,2,43,915,1725,-810
29,2,44,1384,1011,373
29,2,45,1104,983,121
29,2,47,1180,984,196
29,2,48,1036,1254,-218
29,2,49,1083,816,267
29,2,50,958,996,-38
29,2,51,968,851,117
29,2,52,901,857,44
29,2,53,943,928,15
29,2,55,971,829,142
29,2,56,1045,876,169
29,2,57,1099,961,138
29,2,58,980,1228,-248
29,2,59,1494,1108,386
29,2,60,843,873,-30
29,2,61,1049,819,230
29,2,62,946,1208,-262
29,2,63,928,1025,-97
29,2,64,848,903,-55
29,2,65,1018,1031,-13
29,2,67,1043,899,144
29,2,68,1111,975,136
29,2,69,805,1105,-300
29,2,70,862,1087,-225
29,2,71,894,871,23
29,2,72,820,898,-78
30,2,1,936,977,-41
30,2,2,987,1400,-413
30,2,3,938,1184,-246
30,2,4,882,803,79
30,2,5,859,888,-29
30,2,6,1136,1173,-37
30,2,7,1121,1098,23
30,2,8,1094,972,122
30,2,10,1279,1174,105
30,2,11,1058,1045,13
30,2,12,1022,1048,-26
30,2,13,1049,853,196
30,2,14,684,703,-19
30,2,15,800,750,50
30,2,16,790,720,70
30,2,17,775,712,63
30,2,18,1201,706,495
30,2,19,830,664,166
30,2,20,795,788,7
30,2,21,915,678,237
30,2,22,867,873,-6
30,2,23,773,959,-186
30,2,24,796,869,-73
30,2,25,815,862,-47
30,2,26,810,831,-21
30,2,27,769,698,71
30,2,28,802,815,-13
30,2,29,697,594,103
30,2,30,774,984,-210
30,2,31,794,699,95
30,2,32,784,1000,-216
30,2,33,931,1018,-87
30,2,34,761,832,-71
30,2,36,849,940,-91
30,2,37,665,733,-68
30,2,38,813,842,-29
30,2,39,916,769,147
30,2,40,783,785,-2
30,2,41,800,648,152
30,2,42,867,814,53
30,2,43,873,685,188
30,2,44,759,790,-31
30,2,45,910,734,176
30,2,46,800,818,-18
30,2,48,907,780,127
30,2,49,740,885,-145
30,2,50,756,720,36
30,2,51,786,853,-67
30,2,52,761,940,-179
30,2,53,718,710,8
30,2,54,793,757,36
30,2,55,733,952,-219
30,2,56,717,716,1
30,2,58,792,711,81
30,2,59,712,664,48
30,2,60,709,928,-219
30,2,61,762,730,32
30,2,62,767,729,38
30,2,63,796,718,78
30,2,64,701,732,-31
30,2,65,882,902,-20
30,2,66,810,638,172
30,2,67,801,969,-168
30,2,69,790,646,144
30,2,70,746,787,-41
30,2,71,749,801,-52
30,2,72,816,727,89
31,3,1,991,1219,-228
31,3,2,1263,1252,11
31,3,3,872,1101,-229
31,3,4,989,1070,-81
31,3,5,947,912,35
31,3,6,974,757,217
31,3,7,961,790,171
31,3,8,983,1018,-35
31,3,9,813,782,31
31,3,10,875,834,41
31,3,11,1085,804,281
31,3,12,902,1328,-426
31,3,13,1050,658,392
31,3,14,950,752,198
31,3,15,928,903,25
31,3,16,900,820,80
31,3,17,822,812,10
31,3,18,824,699,125
31,3,19,861,823,38
31,3,21,966,713,253
31,3,22,798,537,261
31,3,23,843,649,194
31,3,24,783,683,100
31,3,25,912,677,235
31,3,26,785,583,202
31,3,27,847,725,122
31,3,28,717,631,86
31,3,29,869,711,158
31,3,30,867,666,201
31,3,31,785,795,-10
31,3,33,988,951,37
31,3,34,899,694,205
31,3,35,899,719,180
31,3,36,756,1088,-332
31,3,37,995,658,337
31,3,38,805,751,54
31,3,39,759,918,-159
31,3,40,825,783,42
31,3,41,705,670,35
31,3,42,891,749,142
31,3,43,802,730,72
31,3,44,708,612,96
31,3,45,875,685,190
31,3,46,827,741,86
31,3,47,752,646,106
31,3,48,649,883,-234
31,3,49,826,606,220
31,3,50,678,606,72
31,3,51,761,648,113
31,3,52,743,626,117
31,3,53,771,487,284
31,3,54,740,663,77
31,3,55,785,662,123
31,3,56,708,643,65
31,3,57,817,588,229
31,3,58,771,626,145
31,3,59,779,609,170
31,3,60,735,578,157
31,3,61,673,635,38
31,3,62,710,611,99
31,3,63,667,625,42
31,3,64,716,610,106
31,3,65,777,639,138
31,3,66,787,583,204
31,3,67,817,728,89
31,3,68,797,624,173
31,3,69,775,451,324
31,3,70,650,648,2
31,3,71,716,501,215
31,3,72,859,788,71
32,2,1,729,1009,-280
32,2,2,653,814,-161
32,2,3,838,771,67
32,2,4,795,754,41
32,2,5,676,708,-32
32,2,6,700,694,6
32,2,7,733,670,63
32,2,8,698,836,-138
32,2,9,687,701,-14
32,2,10,673,728,-55
32,2,11,866,799,67
32,2,12,676,704,-28
32,2,13,737,910,-173
32,2,14,702,682,20
32,2,15,688,701,-13
32,2,16,682,652,30
32,2,17,678,697,-19
32,2,18,875,839,36
32,2,19,712,630,82
32,2,20,696,726,-30
32,2,21,784,750,34
32,2,22,678,614,64
32,2,23,697,740,-43
32,2,24,651,666,-15
32,2,25,700,660,40
32,2,26,721,618,103
32,2,27,679,653,26
32,2,28,654,615,39
32,2,30,657,651,6
32,2,32,670,647,23
32,2,33,669,777,-108
32,2,34,720,640,80
32,2,35,655,635,20
32,2,36,627,613,14
32,2,37,680,675,5
32,2,39,703,652,51
32,2,40,704,654,50
32,2,41,734,681,53
32,2,42,806,657,149
32,2,43,718,673,45
32,2,44,715,778,-63
32,2,45,628,717,-89
32,2,46,649,723,-74
32,2,47,672,641,31
32,2,48,695,602,93
32,2,49,784,650,134
32,2,50,769,979,-210
32,2,51,675,673,2
32,2,52,757,776,-19
32,2,53,725,1249,-524
32,2,54,732,617,115
32,2,55,671,700,-29
32,2,56,762,644,118
32,2,57,783,630,153
32,2,58,681,656,25
32,2,59,704,667,37
32,2,60,1063,742,321
32,2,61,673,677,-4
32,2,62,683,526,157
32,2,63,706,625,81
32,2,64,617,604,13
32,2,65,596,623,-27
32,2,66,676,805,-129
32,2,67,693,706,-13
32,2,68,784,590,194
32,2,69,741,679,62
32,2,70,595,699,-104
32,2,71,643,633,10
32,2,72,1018,955,63
33,1,1,802,1019,-217
33,1,2,799,1062,-263
33,1,3,744,702,42
33,1,4,784,762,22
33,1,5,821,864,-43
33,1,6,551,365,186
33,1,7,706,378,328
33,1,8,1088,387,701
33,1,9,968,323,645
33,1,10,871,308,563
33,1,11,507,491,16
33,1,16,856,78,778
33,1,17,1205,367,838
33,1,18,926,490,436
33,1,19,673,258,415
33,1,20,820,134,686
33,1,21,534,138,396
33,1,22,515,102,413
33,1,23,809,172,637
33,1,24,935,112,823
33,1,25,878,38,840
33,1,26,792,133,659
33,1,27,772,69,703
33,1,28,659,11,648
33,1,29,658,10,648
33,1,30,710,11,699
33,1,31,612,20,592
33,1,32,821,5,816
33,1,33,562,7,555
33,1,34,719,16,703
33,1,35,717,3,714
33,1,36,584,4,580
33,1,37,900,8,892
33,1,38,852,3,849
33,1,39,799,12,787
33,1,40,730,336,394
33,1,41,1074,157,917
33,1,42,820,4,816
33,1,43,695,211,484
33,1,44,803,8,795
33,1,45,858,24,834
33,1,47,716,163,553
33,1,48,798,26,772
33,1,49,957,18,939
33,1,50,571,17,554
33,1,51,816,20,796
33,1,52,809,441,368
33,1,53,854,24,830
33,1,54,903,521,382
33,1,55,797,11,786
33,1,56,846,300,546
33,1,57,731,25,706
33,1,59,620,20,600
33,1,60,878,10,868
33,1,61,858,19,839
33,1,62,1542,298,1244
33,1,63,980,3,977
33,1,64,876,8,868
33,1,66,1048,27,1021
33,1,67,769,12,757
33,1,69,844,28,816
33,1,70,707,14,693
33,1,71,820,23,797
33,1,72,734,28,706
34,3,1,962,1078,-116
34,3,2,984,927,57
34,3,3,905,1000,-95
34,3,4,982,1206,-224
34,3,5,1015,810,205
34,3,6,1003,928,75
34,3,7,867,925,-58
34,3,8,1017,821,196
34,3,9,1070,805,265
34,3,10,921,783,138
34,3,11,895,887,8
34,3,12,1036,774,262
34,3,13,813,791,22
34,3,14,961,898,63
34,3,15,891,743,148
34,3,16,1052,933,119
34,3,17,943,802,141
34,3,18,893,799,94
34,3,19,1004,781,223
34,3,20,995,829,166
34,3,21,919,858,61
34,3,22,929,640,289
34,3,23,894,655,239
34,3,24,892,819,73
34,3,25,987,724,263
34,3,27,926,712,214
34,3,28,889,715,174
34,3,29,906,847,59
34,3,30,952,780,172
34,3,31,972,778,194
34,3,32,819,807,12
34,3,33,1022,802,220
34,3,34,878,762,116
34,3,35,924,850,74
34,3,36,871,880,-9
34,3,37,922,734,188
34,3,38,775,801,-26
34,3,39,916,814,102
34,3,40,951,786,165
34,3,41,889,817,72
34,3,42,830,780,50
34,3,43,795,650,145
34,3,44,826,1121,-295
34,3,45,899,962,-63
34,3,46,852,801,51
34,3,47,841,745,96
34,3,48,859,711,148
34,3,49,790,661,129
34,3,50,851,739,112
34,3,51,827,749,78
34,3,52,823,773,50
34,3,53,828,710,118
34,3,54,768,693,75
34,3,55,736,662,74
34,3,56,801,769,32
34,3,57,877,708,169
34,3,58,836,776,60
34,3,59,844,688,156
34,3,60,843,783,60
34,3,62,785,759,26
34,3,63,816,736,80
34,3,64,965,1150,-185
34,3,65,835,712,123
34,3,66,771,654,117
34,3,67,814,802,12
34,3,68,778,737,41
34,3,69,806,669,137
34,3,70,765,728,37
34,3,71,797,982,-185
34,3,72,792,750,42
35,2,2,995,1362,-367
35,2,3,961,1211,-250
35,2,4,923,1109,-186
35,2,5,1062,1150,-88
35,2,6,1090,1100,-10
35,2,7,999,1136,-137
35,2,8,989,1055,-66
35,2,9,905,1193,-288
35,2,10,864,1072,-208
35,2,11,889,1218,-329
35,2,12,858,1064,-206
35,2,13,1022,1154,-132
35,2,14,969,1033,-64
35,2,15,875,997,-122
35,2,16,1377,973,404
35,2,17,840,946,-106
35,2,18,835,1029,-194
35,2,19,944,1043,-99
35,2,20,980,988,-8
35,2,21,831,1309,-478
35,2,22,905,1158,-253
35,2,23,799,994,-195
35,2,24,866,1051,-185
35,2,25,874,1027,-153
35,2,26,799,991,-192
35,2,27,953,964,-11
35,2,28,855,844,11
35,2,29,808,884,-76
35,2,30,915,893,22
35,2,31,834,805,29
35,2,32,791,1174,-383
35,2,33,891,981,-90
35,2,34,911,935,-24
35,2,35,871,1065,-194
35,2,36,796,847,-51
35,2,37,855,871,-16
35,2,38,842,1004,-162
35,2,39,789,863,-74
35,2,40,791,963,-172
35,2,41,821,847,-26
35,2,42,871,952,-81
35,2,43,876,862,14
35,2,44,839,849,-10
35,2,45,930,936,-6
35,2,46,859,1043,-184
35,2,47,793,921,-128
35,2,48,797,942,-145
35,2,49,1060,909,151
35,2,50,898,1397,-499
35,2,51,901,957,-56
35,2,52,795,1056,-261
35,2,53,1174,965,209
35,2,54,801,1219,-418
35,2,55,1205,935,270
35,2,56,876,894,-18
35,2,57,836,863,-27
35,2,58,794,835,-41
35,2,59,761,910,-149
35,2,60,824,848,-24
35,2,61,866,782,84
35,2,62,819,800,19
35,2,63,815,819,-4
35,2,64,702,776,-74
35,2,65,890,970,-80
35,2,66,896,833,63
35,2,67,818,974,-156
35,2,68,847,832,15
35,2,69,950,1047,-97
35,2,70,747,812,-65
35,2,71,808,904,-96
35,2,72,748,732,16
36,1,1,922,1359,-437
36,1,2,927,1574,-647
36,1,3,930,997,-67
36,1,4,1071,1253,-182
36,1,5,960,1009,-49
36,1,6,952,387,565
36,1,7,879,352,527
36,1,8,918,375,543
36,1,9,1111,493,618
36,1,10,979,432,547
36,1,11,903,447,456
36,1,12,963,479,484
36,1,13,1021,358,663
36,1,14,598,254,344
36,1,16,651,4,647
36,1,17,605,45,560
36,1,18,349,134,215
36,1,20,623,62,561
36,1,21,955,413,542
36,1,22,884,425,459
36,1,23,868,60,808
36,1,24,938,193,745
36,1,25,1604,49,1555
36,1,26,1091,137,954
36,1,27,1108,187,921
36,1,28,1021,959,62
36,1,29,951,7,944
36,1,30,926,14,912
36,1,31,653,322,331
36,1,32,965,374,591
36,1,33,1084,23,1061
36,1,34,1151,487,664
36,1,35,524,168,356
36,1,36,1070,303,767
36,1,38,902,108,794
36,1,40,853,161,692
36,1,41,1128,123,1005
36,1,42,928,126,802
36,1,43,782,253,529
36,1,44,659,91,568
36,1,45,797,46,751
36,1,46,947,4,943
36,1,47,859,64,795
36,1,48,1164,92,1072
36,1,49,1063,5,1058
36,1,50,904,134,770
36,1,51,477,74,403
36,1,52,1246,108,1138
36,1,53,1415,44,1371
36,1,54,1153,52,1101
36,1,55,1200,1024,176
36,1,56,1060,1002,58
36,1,57,1185,191,994
36,1,58,840,142,698
36,1,59,922,25,897
36,1,60,972,98,874
36,1,61,862,93,769
36,1,62,529,500,29
36,1,63,1062,10,1052
36,1,64,926,133,793
36,1,65,646,120,526
36,1,66,583,159,424
36,1,67,866,53,813
36,1,68,1117,445,672
36,1,69,950,75,875
36,1,70,918,125,793
36,1,71,524,163,361
36,1,72,1203,427,776
37,2,1,859,1027,-168
37,2,2,803,956,-153
37,2,3,880,1011,-131
37,2,4,897,965,-68
37,2,5,736,886,-150
37,2,6,1032,906,126
37,2,7,915,875,40
37,2,8,819,803,16
37,2,10,766,787,-21
37,2,11,1297,830,467
37,2,12,815,850,-35
37,2,13,786,778,8
37,2,14,791,802,-11
37,2,15,751,655,96
37,2,16,828,749,79
37,2,17,768,708,60
37,2,18,851,746,105
37,2,19,1118,773,345
37,2,20,835,763,72
37,2,21,737,728,9
37,2,22,775,651,124
37,2,24,758,711,47
37,2,25,771,348,423
37,2,26,688,191,497
37,2,27,696,827,-131
37,2,28,896,755,141
37,2,30,783,808,-25
37,2,31,818,496,322
37,2,32,793,1045,-252
37,2,33,715,740,-25
37,2,34,836,799,37
37,2,35,656,248,408
37,2,36,709,771,-62
37,2,37,770,636,134
37,2,38,844,363,481
37,2,39,633,326,307
37,2,40,846,720,126
37,2,42,865,105,760
37,2,43,537,276,261
37,2,45,728,808,-80
37,2,46,839,154,685
37,2,48,699,698,1
37,2,49,512,170,342
37,2,50,723,271,452
37,2,51,592,148,444
37,2,52,778,828,-50
37,2,53,781,247,534
37,2,54,510,68,442
37,2,55,603,249,354
37,2,57,775,205,570
37,2,58,749,343,406
37,2,59,852,226,626
37,2,60,614,162,452
37,2,61,699,317,382
37,2,62,666,113,553
37,2,63,700,376,324
37,2,64,794,859,-65
37,2,65,885,404,481
37,2,66,621,706,-85
37,2,67,639,9,630
37,2,68,715,82,633
37,2,69,657,101,556
37,2,70,688,12,676
37,2,72,768,7,761
38,1,1,1179,1573,-394
38,1,2,1151,1255,-104
38,1,3,1171,1131,40
38,1,4,1133,1037,96
38,1,5,1276,1076,200
38,1,6,1278,1102,176
38,1,7,1420,1114,306
38,1,8,1339,943,396
38,1,9,1087,802,285
38,1,10,1743,727,1016
38,1,11,1235,859,376
38,1,12,1114,836,278
38,1,13,1169,637,532
38,1,14,1234,348,886
38,1,15,1112,715,397
38,1,16,1253,685,568
38,1,17,1756,1005,751
38,1,18,885,575,310
38,1,19,944,637,307
38,1,21,1065,188,877
38,1,22,1167,785,382
38,1,23,1189,53,1136
38,1,24,1064,625,439
38,1,25,958,383,575
38,1,26,1089,890,199
38,1,27,1054,638,416
38,1,28,1057,210,847
38,1,30,1168,842,326
38,1,31,1078,773,305
38,1,32,1232,649,583
38,1,36,1094,1240,-146
38,1,54,1033,196,837
38,1,56,1131,148,983
39,1,2,959,1083,-124
39,1,3,812,876,-64
39,1,4,940,869,71
39,1,5,909,751,158
39,1,6,820,795,25
39,1,7,855,734,121
39,1,8,868,800,68
39,1,9,869,707,162
39,1,10,607,931,-324
39,1,11,850,754,96
39,1,12,483,824,-341
39,1,13,861,678,183
39,1,14,773,757,16
39,1,15,830,775,55
39,1,16,755,907,-152
39,1,17,756,682,74
39,1,18,720,890,-170
39,1,19,703,789,-86
39,1,20,867,753,114
39,1,21,844,735,109
39,1,22,763,674,89
39,1,23,814,891,-77
39,1,24,877,886,-9
39,1,25,985,627,358
39,1,26,843,745,98
39,1,27,745,812,-67
39,1,28,700,737,-37
39,1,29,716,796,-80
39,1,30,824,775,49
39,1,31,859,853,6
39,1,32,751,724,27
39,1,33,832,851,-19
39,1,34,761,559,202
39,1,35,810,730,80
39,1,36,723,697,26
39,1,37,712,730,-18
39,1,38,558,754,-196
39,1,39,768,774,-6
39,1,40,781,790,-9
39,1,41,736,734,2
39,1,42,881,524,357
39,1,43,724,523,201
39,1,44,511,357,154
39,1,45,721,384,337
39,1,46,889,559,330
39,1,47,776,647,129
39,1,48,753,422,331
39,1,49,736,391,345
39,1,50,740,547,193
39,1,51,794,554,240
39,1,52,732,377,355
39,1,53,769,422,347
39,1,55,779,421,358
39,1,56,730,373,357
39,1,57,831,623,208
39,1,58,753,497,256
39,1,59,788,644,144
39,1,60,725,1162,-437
39,1,61,701,422,279
39,1,62,679,683,-4
39,1,63,743,467,276
39,1,64,724,541,183
39,1,65,784,362,422
39,1,66,939,448,491
39,1,67,503,308,195
39,1,68,789,458,331
39,1,69,731,615,116
39,1,70,679,435,244
39,1,71,801,498,303
39,1,72,690,470,220
40,2,1,845,1132,-287
40,2,2,757,847,-90
40,2,3,822,723,99
40,2,4,822,925,-103
40,2,5,942,878,64
40,2,6,1073,845,228
40,2,7,738,741,-3
40,2,8,850,718,132
40,2,9,890,709,181
40,2,10,944,732,212
40,2,11,842,838,4
40,2,12,854,880,-26
40,2,13,1285,661,624
40,2,14,684,803,-119
40,2,15,1114,713,401
40,2,16,829,795,34
40,2,17,750,754,-4
40,2,18,814,714,100
40,2,19,762,680,82
40,2,21,795,679,116
40,2,22,771,671,100
40,2,23,738,704,34
40,2,24,755,655,100
40,2,25,966,651,315
40,2,26,764,748,16
40,2,27,810,682,128
40,2,28,680,656,24
40,2,29,878,601,277
40,2,30,797,794,3
40,2,31,812,633,179
40,2,32,784,638,146
40,2,33,740,839,-99
40,2,34,803,668,135
40,2,35,760,663,97
40,2,36,777,729,48
40,2,37,828,997,-169
40,2,38,786,720,66
40,2,39,689,681,8
40,2,40,756,760,-4
40,2,41,779,645,134
40,2,42,856,632,224
40,2,43,820,756,64
40,2,44,810,651,159
40,2,45,911,632,279
40,2,46,688,645,43
40,2,47,789,628,161
40,2,48,803,636,167
40,2,49,762,687,75
40,2,51,695,649,46
40,2,52,895,663,232
40,2,53,746,667,79
40,2,54,702,745,-43
40,2,55,728,660,68
40,2,56,763,686,77
40,2,57,773,776,-3
40,2,58,782,651,131
40,2,59,752,675,77
40,2,60,787,656,131
40,2,61,688,720,-32
40,2,62,1023,941,82
40,2,63,751,672,79
40,2,64,708,615,93
40,2,65,1040,677,363
40,2,66,762,665,97
40,2,67,740,661,79
40,2,68,683,731,-48
40,2,69,753,640,113
40,2,71,686,674,12
40,2,72,752,661,91
41,1,1,1157,1422,-265
41,1,2,1011,1324,-313
41,1,3,989,1334,-345
41,1,5,774,460,314
41,1,6,856,744,112
41,1,7,843,407,436
41,1,8,857,38,819
41,1,9,790,320,470
41,1,10,590,171,419
41,1,12,951,262,689
41,1,14,878,188,690
41,1,15,726,32,694
41,1,16,926,97,829
41,1,17,958,207,751
41,1,18,829,159,670
41,1,19,730,132,598
41,1,20,836,168,668
41,1,21,1107,112,995
41,1,22,891,112,779
41,1,23,1083,32,1051
41,1,24,1046,415,631
41,1,25,1214,21,1193
41,1,26,1386,9,1377
41,1,29,957,125,832
41,1,30,861,242,619
41,1,32,678,55,623
41,1,33,909,60,849
41,1,34,793,46,747
41,1,35,703,66,637
41,1,36,842,46,796
41,1,37,857,17,840
41,1,38,772,22,750
41,1,39,630,95,535
41,1,40,911,22,889
41,1,41,829,40,789
41,1,42,921,72,849
41,1,43,761,12,749
41,1,44,1653,83,1570
41,1,45,814,80,734
41,1,46,790,72,718
41,1,47,773,2,771
41,1,48,763,73,690
41,1,49,832,34,798
41,1,50,865,59,806
41,1,51,730,39,691
41,1,52,1001,30,971
41,1,53,811,66,745
41,1,54,829,402,427
41,1,55,863,3,860
41,1,56,934,69,865
41,1,57,939,7,932
41,1,58,956,38,918
41,1,59,1039,72,967
41,1,60,859,52,807
41,1,61,873,57,816
41,1,62,764,38,726
41,1,63,885,2,883
41,1,64,782,2,780
41,1,65,1364,27,1337
41,1,66,621,37,584
41,1,67,773,20,753
41,1,68,923,38,885
41,1,69,879,68,811
41,1,70,876,82,794
41,1,72,1329,265,1064
42,1,1,849,991,-142
42,1,2,776,725,51
42,1,3,665,640,25
42,1,4,698,590,108
42,1,5,665,575,90
42,1,6,670,596,74
42,1,8,709,666,43
42,1,9,729,629,100
42,1,10,694,603,91
42,1,11,657,599,58
42,1,12,683,408,275
42,1,13,1086,1108,-22
42,1,14,1083,1162,-79
42,1,15,872,1101,-229
42,1,16,1062,1065,-3
42,1,17,887,1075,-188
42,1,18,1034,1106,-72
42,1,19,1475,1049,426
42,1,20,917,1055,-138
42,1,21,980,1057,-77
42,1,22,1126,1115,11
42,1,23,1064,1302,-238
42,1,24,1036,1129,-93
42,1,25,1038,1094,-56
42,1,26,907,1000,-93
42,1,27,991,1077,-86
42,1,28,1036,1011,25
42,1,29,925,932,-7
42,1,30,973,1210,-237
42,1,31,961,878,83
42,1,32,994,1021,-27
42,1,33,988,955,33
42,1,34,919,1084,-165
42,1,35,940,1058,-118
42,1,36,923,890,33
42,1,37,876,1130,-254
42,1,38,885,914,-29
42,1,39,861,1050,-189
42,1,40,894,1044,-150
42,1,41,1152,1029,123
42,1,42,955,1161,-206
42,1,43,926,875,51
42,1,44,990,811,179
42,1,45,453,938,-485
42,1,46,897,958,-61
42,1,47,908,841,67
42,1,48,862,1036,-174
42,1,50,775,965,-190
42,1,53,949,1249,-300
42,1,55,833,839,-6
42,1,56,894,837,57
42,1,58,1313,1319,-6
42,1,60,754,775,-21
42,1,61,845,772,73
42,1,63,755,946,-191
42,1,65,881,909,-28
42,1,68,875,839,36
42,1,70,970,1528,-558
42,1,72,1161,1000,161
43,2,1,1037,1211,-174
43,2,2,1106,1230,-124
43,2,3,1046,1120,-74
43,2,4,859,956,-97
43,2,5,1024,1118,-94
43,2,6,1056,1075,-19
43,2,7,1012,1243,-231
43,2,8,993,968,25
43,2,9,919,1106,-187
43,2,13,877,509,368
43,2,14,802,426,376
43,2,15,884,443,441
43,2,16,926,512,414
43,2,17,800,619,181
43,2,18,844,595,249
43,2,19,896,548,348
43,2,20,908,524,384
43,2,21,838,355,483
43,2,22,882,393,489
43,2,23,941,381,560
43,2,24,896,461,435
43,2,25,880,366,514
43,2,26,783,387,396
43,2,27,1104,384,720
43,2,28,805,325,480
43,2,29,901,59,842
43,2,30,799,427,372
43,2,31,1084,698,386
43,2,32,1171,1115,56
43,2,33,883,419,464
43,2,34,848,426,422
43,2,35,802,337,465
43,2,36,881,406,475
43,2,37,870,415,455
43,2,38,870,373,497
43,2,39,1173,584,589
43,2,40,961,263,698
43,2,41,933,564,369
43,2,42,859,421,438
43,2,43,847,385,462
43,2,44,912,423,489
43,2,45,853,382,471
43,2,46,894,351,543
43,2,47,914,362,552
43,2,48,875,320,555
43,2,49,1259,295,964
43,2,50,832,376,456
43,2,51,933,372,561
43,2,52,990,357,633
43,2,53,852,403,449
43,2,55,902,390,512
43,2,56,853,298,555
43,2,57,854,372,482
43,2,58,860,514,346
43,2,59,731,419,312
43,2,60,709,378,331
43,2,61,922,283,639
43,2,62,780,259,521
43,2,63,853,263,590
43,2,64,926,85,841
43,2,65,793,329,464
43,2,66,760,538,222
43,2,67,801,354,447
43,2,68,776,264,512
43,2,69,729,283,446
43,2,70,796,293,503
43,2,71,945,354,591
43,2,72,739,266,473
44,1,1,861,1045,-184
44,1,2,789,1013,-224
44,1,3,821,837,-16
44,1,4,885,1133,-248
44,1,5,1749,1293,456
44,1,6,766,814,-48
44,1,7,806,822,-16
44,1,8,765,789,-24
44,1,9,853,725,128
44,1,10,869,813,56
44,1,11,1013,861,152
44,1,12,997,869,128
44,1,13,923,712,211
44,1,14,1112,776,336
44,1,15,849,793,56
44,1,16,769,801,-32
44,1,17,840,864,-24
44,1,18,800,768,32
44,1,19,776,768,8
44,1,20,768,808,-40
44,1,21,832,776,56
44,1,22,792,656,136
44,1,23,944,680,264
44,1,24,840,712,128
44,1,26,1291,1147,144
44,1,27,1636,1059,577
44,1,28,1259,1060,199
44,1,29,764,796,-32
44,1,30,788,708,80
44,1,31,756,716,40
44,1,32,884,756,128
44,1,33,820,644,176
44,1,34,860,717,143
44,1,35,835,1355,-520
44,1,36,763,716,47
44,1,38,1044,780,264
44,1,39,748,700,48
44,1,40,780,1508,-728
44,1,41,875,772,103
44,1,42,1348,980,368
44,1,43,860,716,144
44,1,44,932,1411,-479
44,1,45,1131,1868,-737
44,1,46,1172,1100,72
44,1,47,1620,780,840
44,1,48,1564,956,608
44,1,49,727,688,39
44,1,50,792,648,144
44,1,51,824,768,56
44,1,52,887,767,120
44,1,53,687,855,-168
44,1,54,823,703,120
44,1,55,783,695,88
44,1,56,823,719,104
44,1,57,903,767,136
44,1,58,816,824,-8
44,1,59,888,680,208
44,1,60,888,888,0
44,1,61,852,762,90
44,1,63,801,705,96
44,1,64,929,745,184
44,1,65,785,769,16
44,1,66,777,817,-40
44,1,67,849,713,136
44,1,68,881,745,136
44,1,69,841,809,32
44,1,71,809,761,48
44,1,72,777,1153,-376
45,3,1,1205,1372,-167
45,3,2,1141,1265,-124
45,3,3,1020,1191,-171
45,3,4,967,1179,-212
45,3,5,1117,1192,-75
45,3,6,1139,1133,6
45,3,7,1169,1289,-120
45,3,8,969,1061,-92
45,3,9,1055,1098,-43
45,3,10,875,1050,-175
45,3,11,1030,1093,-63
45,3,12,993,1011,-18
45,3,13,1115,1080,35
45,3,14,941,989,-48
45,3,15,941,1095,-154
45,3,16,1114,1166,-52
45,3,17,911,984,-73
45,3,18,930,899,31
45,3,19,913,1021,-108
45,3,20,914,1038,-124
45,3,21,950,1211,-261
45,3,22,1037,1050,-13
45,3,23,922,1046,-124
45,3,24,979,949,30
45,3,26,896,1039,-143
45,3,27,979,1035,-56
45,3,28,810,1098,-288
45,3,29,994,1037,-43
45,3,30,903,1039,-136
45,3,31,933,1018,-85
45,3,33,1005,953,52
45,3,34,878,907,-29
45,3,35,879,1083,-204
45,3,36,876,929,-53
45,3,37,854,909,-55
45,3,38,876,986,-110
45,3,39,868,1040,-172
45,3,40,708,892,-184
45,3,41,888,853,35
45,3,42,797,998,-201
45,3,43,850,1045,-195
45,3,44,849,854,-5
45,3,45,906,935,-29
45,3,46,811,964,-153
45,3,47,833,1076,-243
45,3,48,923,953,-30
45,3,49,816,966,-150
45,3,50,846,1006,-160
45,3,51,928,1039,-111
45,3,52,914,1050,-136
45,3,53,864,923,-59
45,3,54,942,993,-51
45,3,55,865,950,-85
45,3,56,797,857,-60
45,3,57,782,993,-211
45,3,58,959,1088,-129
45,3,59,914,1022,-108
45,3,60,901,1018,-117
45,3,61,828,987,-159
45,3,62,805,1032,-227
45,3,63,817,1088,-271
45,3,64,818,1151,-333
45,3,65,820,1066,-246
45,3,66,889,1043,-154
45,3,67,801,927,-126
45,3,68,836,1132,-296
45,3,70,863,1015,-152
45,3,71,1050,974,76
45,3,72,882,1040,-158
46,1,9,1394,677,717
46,1,10,829,399,430
46,1,11,1213,560,653
46,1,12,1097,476,621
46,1,13,1031,33,998
46,1,14,1032,447,585
46,1,15,1098,509,589
46,1,16,974,207,767
46,1,17,854,104,750
46,1,18,1072,64,1008
46,1,19,773,238,535
46,1,20,1061,192,869
46,1,21,639,154,485
46,1,22,884,70,814
46,1,23,857,99,758
46,1,24,889,379,510
46,1,25,1213,265,948
46,1,26,887,327,560
46,1,27,620,46,574
46,1,28,670,398,272
46,1,29,624,483,141
46,1,30,903,218,685
46,1,31,1198,376,822
46,1,32,637,251,386
46,1,33,776,134,642
46,1,34,736,41,695
46,1,35,952,289,663
46,1,36,793,292,501
46,1,37,704,379,325
46,1,38,1009,396,613
46,1,39,666,548,118
46,1,40,697,43,654
46,1,41,846,598,248
46,1,42,1224,105,1119
46,1,43,853,328,525
46,1,44,941,110,831
46,1,45,984,97,887
46,1,46,850,165,685
46,1,47,1030,440,590
46,1,48,870,382,488
46,1,50,1183,305,878
46,1,51,868,343,525
46,1,52,992,162,830
46,1,53,1309,298,1011
46,1,54,814,185,629
46,1,55,1081,756,325
46,1,56,1238,33,1205
46,1,57,821,399,422
46,1,59,823,394,429
46,1,60,915,476,439
46,1,61,1189,222,967
46,1,62,1011,148,863
46,1,64,989,437,552
46,1,65,863,58,805
46,1,66,1017,141,876
46,1,67,1086,176,910
46,1,68,1109,103,1006
46,1,69,969,45,924
46,1,70,1076,398,678
46,1,71,1156,134,1022
46,1,72,825,243,582
47,1,1,857,1435,-578
47,1,2,1042,1259,-217
47,1,3,903,1098,-195
47,1,4,963,1108,-145
47,1,5,910,1049,-139
47,1,6,870,993,-123
47,1,7,863,928,-65
47,1,8,912,1402,-490
47,1,9,878,1305,-427
47,1,10,979,914,65
47,1,11,1046,922,124
47,1,12,869,1390,-521
47,1,13,963,811,152
47,1,14,972,995,-23
47,1,15,904,813,91
47,1,16,688,883,-195
47,1,17,905,625,280
47,1,18,867,850,17
47,1,19,827,829,-2
47,1,20,790,847,-57
47,1,21,993,876,117
47,1,22,816,763,53
47,1,23,1318,727,591
47,1,24,907,980,-73
47,1,25,888,681,207
47,1,26,751,704,47
47,1,28,709,710,-1
47,1,29,783,752,31
47,1,30,779,866,-87
47,1,31,866,1220,-354
47,1,32,823,762,61
47,1,33,783,783,0
47,1,34,951,811,140
47,1,35,915,860,55
47,1,36,1013,908,105
47,1,37,850,842,8
47,1,38,954,1019,-65
47,1,39,841,701,140
47,1,40,895,696,199
47,1,41,814,856,-42
47,1,42,674,877,-203
47,1,44,724,735,-11
47,1,45,913,675,238
47,1,46,757,717,40
47,1,47,712,887,-175
47,1,48,740,799,-59
47,1,49,853,813,40
47,1,50,919,833,86
47,1,51,698,761,-63
47,1,52,770,749,21
47,1,53,956,853,103
47,1,54,883,784,99
47,1,55,699,718,-19
47,1,56,898,948,-50
47,1,57,908,832,76
47,1,58,772,661,111
47,1,59,896,779,117
47,1,60,970,676,294
47,1,61,709,664,45
47,1,62,773,801,-28
47,1,63,694,687,7
47,1,64,875,634,241
47,1,65,884,680,204
47,1,66,777,729,48
47,1,67,909,734,175
47,1,68,724,716,8
47,1,69,771,870,-99
47,1,70,710,607,103
47,1,71,668,687,-19
47,1,72,767,561,206
48,2,1,951,1386,-435
48,2,2,967,1208,-241
48,2,3,946,1099,-153
48,2,4,950,1072,-122
48,2,5,886,917,-31
48,2,6,899,1176,-277
48,2,7,911,902,9
48,2,8,832,785,47
48,2,9,897,1151,-254
48,2,10,1091,1027,64
48,2,11,951,969,-18
48,2,12,832,778,54
48,2,13,883,857,26
48,2,14,954,1039,-85
48,2,15,824,902,-78
48,2,16,916,816,100
48,2,17,885,773,112
48,2,18,879,992,-113
48,2,19,860,843,17
48,2,20,830,1034,-204
48,2,21,873,874,-1
48,2,22,884,842,42
48,2,23,928,895,33
48,2,24,899,887,12
48,2,25,849,843,6
48,2,26,906,797,109
48,2,27,861,819,42
48,2,28,543,770,-227
48,2,29,571,827,-256
48,2,30,828,780,48
48,2,31,1172,2662,-1490
48,2,32,908,976,-68
48,2,33,543,816,-273
48,2,34,921,869,52
48,2,35,941,901,40
48,2,36,893,862,31
48,2,37,804,871,-67
48,2,38,939,779,160
48,2,39,829,814,15
48,2,40,885,902,-17
48,2,41,921,867,54
48,2,42,602,823,-221
48,2,43,607,1157,-550
48,2,44,927,880,47
48,2,45,1009,994,15
48,2,46,918,917,1
48,2,47,856,892,-36
48,2,48,841,1017,-176
48,2,49,1021,1038,-17
48,2,50,861,1002,-141
48,2,51,828,1227,-399
48,2,52,932,957,-25
48,2,53,919,1017,-98
48,2,54,1053,1061,-8
48,2,55,855,909,-54
48,2,56,853,1082,-229
48,2,57,1035,1031,4
48,2,58,959,548,411
48,2,59,846,776,70
48,2,60,1083,1030,53
48,2,61,904,895,9
48,2,62,846,826,20
48,2,63,798,934,-136
48,2,64,845,914,-69
48,2,65,839,871,-32
48,2,66,832,790,42
48,2,67,698,470,228
48,2,68,895,1319,-424
48,2,69,996,1262,-266
48,2,70,912,1031,-119
48,2,71,898,1015,-117
48,2,72,1035,1290,-255
49,2,1,878,1044,-166
49,2,2,917,1019,-102
49,2,3,870,951,-81
49,2,5,889,1066,-177
49,2,6,862,1009,-147
49,2,7,913,1053,-140
49,2,8,917,1047,-130
49,2,9,872,939,-67
49,2,10,899,1047,-148
49,2,11,921,963,-42
49,2,12,801,934,-133
49,2,13,901,955,-54
49,2,14,867,1048,-181
49,2,15,926,1092,-166
49,2,16,879,1111,-232
49,2,18,811,898,-87
49,2,19,990,916,74
49,2,20,786,950,-164
49,2,21,915,838,77
49,2,22,941,859,82
49,2,23,797,795,2
49,2,24,853,1001,-148
49,2,25,822,802,20
49,2,26,802,905,-103
49,2,27,738,913,-175
49,2,28,851,1028,-177
49,2,29,825,1099,-274
49,2,30,978,1007,-29
49,2,31,888,1176,-288
49,2,32,941,1034,-93
49,2,33,1003,911,92
49,2,34,960,907,53
49,2,35,909,1046,-137
49,2,36,861,921,-60
49,2,37,795,950,-155
49,2,38,824,1098,-274
49,2,39,934,1036,-102
49,2,41,745,852,-107
49,2,42,826,940,-114
49,2,43,766,1027,-261
49,2,44,933,890,43
49,2,45,832,1099,-267
49,2,46,836,926,-90
49,2,47,1106,814,292
49,2,48,721,949,-228
49,2,49,922,979,-57
49,2,50,798,781,17
49,2,51,935,993,-58
49,2,52,1024,1081,-57
49,2,53,908,1049,-141
49,2,54,839,1063,-224
49,2,55,856,1050,-194
49,2,56,871,1017,-146
49,2,57,896,1098,-202
49,2,58,856,891,-35
49,2,59,983,870,113
49,2,60,814,917,-103
49,2,61,836,979,-143
49,2,62,822,760,62
49,2,64,862,894,-32
49,2,65,965,921,44
49,2,66,1114,709,405
49,2,67,812,932,-120
49,2,68,762,859,-97
49,2,69,999,1104,-105
49,2,70,883,898,-15
49,2,71,840,1124,-284
50,2,1,889,951,-62
50,2,2,872,774,98
50,2,3,824,678,146
50,2,4,879,1037,-158
50,2,5,835,797,38
50,2,6,845,900,-55
50,2,7,1018,782,236
50,2,8,770,751,19
50,2,9,828,795,33
50,2,10,959,740,219
50,2,11,780,801,-21
50,2,12,942,835,107
50,2,13,863,786,77
50,2,14,786,874,-88
50,2,15,834,849,-15
50,2,16,725,755,-30
50,2,17,897,1111,-214
50,2,18,764,749,15
50,2,19,1076,850,226
50,2,20,744,772,-28
50,2,21,1067,794,273
50,2,22,846,760,86
50,2,23,1325,779,546
50,2,24,1522,1123,399
50,2,25,876,604,272
50,2,26,844,738,106
50,2,27,786,833,-47
50,2,28,860,676,184
50,2,29,846,902,-56
50,2,30,830,742,88
50,2,31,892,711,181
50,2,32,749,784,-35
50,2,33,1012,890,122
50,2,34,767,754,13
50,2,35,859,679,180
50,2,36,796,910,-114
50,2,37,744,714,30
50,2,38,845,688,157
50,2,39,895,767,128
50,2,40,618,738,-120
50,2,41,811,908,-97
50,2,42,995,731,264
50,2,43,1185,716,469
50,2,44,583,915,-332
50,2,45,902,835,67
50,2,46,785,848,-63
50,2,47,1372,824,548
50,2,48,847,1442,-595
50,2,50,926,701,225
50,2,51,804,756,48
50,2,52,958,667,291
50,2,53,842,1200,-358
50,2,54,832,719,113
50,2,55,947,792,155
50,2,56,737,1016,-279
50,2,57,787,850,-63
50,2,58,959,704,255
50,2,59,728,752,-24
50,2,60,1007,909,98
50,2,61,1133,1228,-95
50,2,62,953,1053,-100
50,2,63,982,1355,-373
50,2,64,1309,1947,-638
50,2,66,1049,1735,-686
50,2,67,1522,1142,380
50,2,68,938,1155,-217
50,2,69,974,785,189
50,2,70,997,1004,-7
50,2,71,1186,1045,141
50,2,72,982,1164,-182
51,2,1,566,27,539
51,2,2,641,117,524
51,2,3,664,126,538
51,2,4,708,50,658
51,2,5,720,116,604
51,2,6,701,98,603
51,2,7,510,113,397
51,2,8,654,159,495
51,2,9,628,38,590
51,2,10,468,163,305
51,2,11,416,47,369
51,2,12,699,75,624
51,2,13,785,35,750
51,2,14,771,168,603
51,2,15,612,108,504
51,2,16,511,126,385
51,2,17,578,11,567
51,2,18,444,120,324
51,2,19,397,27,370
51,2,20,567,77,490
51,2,21,701,127,574
51,2,22,683,45,638
51,2,23,481,113,368
51,2,24,718,112,606
51,2,25,711,136,575
51,2,26,496,138,358
51,2,27,713,20,693
51,2,28,644,6,638
51,2,29,654,132,522
51,2,30,675,48,627
51,2,31,656,206,450
51,2,32,554,33,521
51,2,33,737,59,678
51,2,34,565,17,548
51,2,35,706,193,513
51,2,36,727,45,682
51,2,37,420,137,283
51,2,38,938,95,843
51,2,39,530,110,420
51,2,40,685,73,612
51,2,41,507,168,339
51,2,42,650,116,534
51,2,43,725,116,609
51,2,44,464,25,439
51,2,45,561,123,438
51,2,46,519,186,333
51,2,47,654,62,592
51,2,48,728,121,607
51,2,50,1048,1079,-31
51,2,51,1065,212,853
51,2,52,1216,935,281
51,2,53,897,961,-64
51,2,54,1104,1083,21
51,2,55,957,1020,-63
51,2,56,841,945,-104
51,2,59,881,1176,-295
51,2,60,819,1119,-300
51,2,61,678,1011,-333
51,2,62,755,1237,-482
51,2,63,765,935,-170
51,2,64,733,931,-198
51,2,65,738,986,-248
51,2,66,780,1129,-349
51,2,67,755,1075,-320
51,2,68,754,930,-176
51,2,69,807,856,-49
51,2,70,696,1263,-567
51,2,71,730,1001,-271
51,2,72,767,492,275
52,3,1,1058,1282,-224
52,3,2,1134,1260,-126
52,3,3,1173,926,247
52,3,5,1414,1250,164
52,3,6,891,801,90
52,3,8,810,1018,-208
52,3,9,815,1278,-463
52,3,10,814,899,-85
52,3,12,1135,999,136
52,3,14,801,1164,-363
52,3,16,1122,1340,-218
52,3,17,1153,940,213
52,3,18,919,1042,-123
52,3,19,932,922,10
52,3,20,991,947,44
52,3,21,1480,1129,351
52,3,22,933,1067,-134
52,3,23,1037,1191,-154
52,3,24,872,1056,-184
52,3,25,840,1015,-175
52,3,27,833,830,3
52,3,28,856,812,44
52,3,29,1039,972,67
52,3,31,790,957,-167
52,3,32,837,775,62
52,3,33,859,865,-6
52,3,34,777,805,-28
52,3,35,795,926,-131
52,3,36,1066,799,267
52,3,38,789,769,20
52,3,39,756,924,-168
52,3,40,739,1013,-274
52,3,41,832,876,-44
52,3,43,779,1197,-418
52,3,44,851,861,-10
52,3,45,828,843,-15
52,3,46,801,833,-32
52,3,47,771,884,-113
52,3,48,844,1001,-157
52,3,49,812,1043,-231
52,3,50,766,910,-144
52,3,51,811,934,-123
52,3,52,812,785,27
52,3,53,857,918,-61
52,3,55,816,1141,-325
52,3,56,946,792,154
52,3,57,836,845,-9
52,3,58,864,768,96
52,3,59,756,719,37
52,3,60,710,1227,-517
52,3,61,759,906,-147
52,3,62,791,1099,-308
52,3,63,848,886,-38
52,3,64,881,838,43
52,3,68,902,856,46
52,3,69,1255,845,410
52,3,70,841,1050,-209
52,3,71,831,963,-132
52,3,72,648,769,-121
53,3,1,924,1136,-212
53,3,2,989,1219,-230
53,3,3,875,1235,-360
53,3,4,894,930,-36
53,3,5,849,978,-129
53,3,6,900,1013,-113
53,3,7,857,990,-133
53,3,8,818,883,-65
53,3,9,963,883,80
53,3,10,884,859,25
53,3,11,914,790,124
53,3,12,914,908,6
53,3,13,958,921,37
53,3,14,975,1135,-160
53,3,23,995,1070,-75
53,3,24,1097,926,171
54,1,1,1023,1383,-360
54,1,2,1117,1047,70
54,1,3,899,1196,-297
54,1,4,927,1183,-256
54,1,5,814,1098,-284
54,1,6,1167,1081,86
54,1,7,939,1006,-67
54,1,9,1118,915,203
54,1,10,923,1068,-145
54,1,12,813,1007,-194
54,1,13,1458,982,476
54,1,14,1232,737,495
54,1,15,1149,1349,-200
54,1,16,760,726,34
54,1,17,1109,955,154
54,1,18,994,886,108
54,1,20,901,898,3
54,1,22,752,882,-130
54,1,23,899,829,70
54,1,24,729,792,-63
54,1,25,830,1107,-277
54,1,28,854,781,73
54,1,29,1030,815,215
54,1,30,939,855,84
54,1,31,830,793,37
54,1,32,819,1087,-268
54,1,33,721,753,-32
54,1,34,882,1167,-285
54,1,35,845,912,-67
54,1,36,748,819,-71
54,1,38,782,721,61
54,1,39,935,919,16
54,1,40,797,696,101
54,1,41,669,982,-313
54,1,42,800,848,-48
54,1,43,778,862,-84
54,1,44,793,795,-2
54,1,45,732,763,-31
54,1,47,765,850,-85
54,1,48,694,709,-15
54,1,49,780,833,-53
54,1,50,817,1129,-312
54,1,51,887,1004,-117
54,1,52,882,913,-31
54,1,53,830,864,-34
54,1,54,814,863,-49
54,1,55,888,599,289
54,1,57,1191,913,278
54,1,58,831,1148,-317
54,1,59,686,1062,-376
54,1,60,782,898,-116
54,1,61,777,968,-191
54,1,62,997,431,566
54,1,63,795,343,452
54,1,64,687,253,434
54,1,65,714,332,382
54,1,66,670,370,300
54,1,67,1012,330,682
54,1,68,817,164,653
54,1,69,735,60,675
54,1,70,831,302,529
54,1,72,707,22,685
55,1,1,1151,1361,-210
55,1,2,1184,1269,-85
55,1,3,1069,1350,-281
55,1,4,1092,1177,-85
55,1,5,1095,1405,-310
55,1,6,1111,1139,-28
55,1,7,1161,1075,86
55,1,8,1049,1005,44
55,1,9,1791,1157,634
55,1,10,1069,1355,-286
55,1,11,1135,1410,-275
55,1,12,1159,1221,-62
55,1,13,1047,1101,-54
55,1,15,1050,1904,-854
55,1,17,1726,1225,501
55,1,18,1085,1259,-174
55,1,19,1228,1240,-12
55,1,20,1682,1537,145
55,1,21,1120,1691,-571
55,1,22,1172,1084,88
55,1,23,1173,1237,-64
55,1,24,1090,1208,-118
55,1,25,1281,1160,121
55,1,27,1537,1779,-242
55,1,28,1320,1410,-90
55,1,29,1562,1122,440
55,1,30,1334,1235,99
55,1,31,1180,1126,54
55,1,32,1112,1335,-223
55,1,33,1096,1220,-124
55,1,34,1709,1213,496
55,1,35,972,1380,-408
55,1,36,995,1368,-373
55,1,37,1093,1385,-292
55,1,38,1096,1166,-70
55,1,39,1080,1148,-68
55,1,40,1010,1050,-40
55,1,41,1014,1574,-560
55,1,42,1156,1142,14
55,1,43,1669,1469,200
55,1,44,974,1295,-321
55,1,45,1021,1169,-148
55,1,46,1036,1362,-326
55,1,47,1973,1068,905
55,1,48,1149,1321,-172
55,1,49,1010,1719,-709
55,1,50,1142,1137,5
55,1,51,1039,1328,-289
55,1,52,1004,1418,-414
55,1,53,987,1351,-364
55,1,54,1126,1320,-194
55,1,55,1015,1302,-287
55,1,56,1567,1130,437
55,1,57,1536,1392,144
55,1,58,1162,1202,-40
55,1,59,1244,1345,-101
55,1,60,1473,1315,158
55,1,61,1017,1177,-160
55,1,62,1076,1190,-114
55,1,63,1011,959,52
55,1,64,1340,1470,-130
55,1,65,1236,1548,-312
55,1,66,691,1031,-340
55,1,68,1129,1213,-84
55,1,69,1080,1277,-197
55,1,72,1036,1086,-50
56,2,1,1165,1109,56
56,2,2,1009,1099,-90
56,2,3,1010,920,90
56,2,4,1150,858,292
56,2,5,1214,983,231
56,2,6,1106,949,157
56,2,7,1095,981,114
56,2,8,992,1027,-35
56,2,10,1385,1057,328
56,2,11,1251,992,259
56,2,12,1075,934,141
56,2,13,1087,882,205
56,2,14,947,861,86
56,2,15,1034,885,149
56,2,16,1027,914,113
56,2,17,1043,1046,-3
56,2,18,924,876,48
56,2,19,930,1120,-190
56,2,20,940,900,40
56,2,21,913,872,41
56,2,22,1060,810,250
56,2,23,906,799,107
56,2,24,1373,1089,284
56,2,25,1143,882,261
56,2,26,1013,842,171
56,2,27,931,953,-22
56,2,28,905,819,86
56,2,29,984,962,22
56,2,31,1254,921,333
56,2,32,1057,893,164
56,2,33,1081,897,184
56,2,34,1174,900,274
56,2,35,937,891,46
56,2,36,1143,839,304
56,2,37,1253,1133,120
56,2,38,1086,1103,-17
56,2,39,1093,1149,-56
56,2,40,1044,1030,14
56,2,41,1119,967,152
56,2,42,1249,893,356
56,2,43,1122,883,239
56,2,44,924,908,16
56,2,45,919,851,68
56,2,46,1083,902,181
56,2,47,929,875,54
56,2,48,913,994,-81
56,2,49,1526,1084,442
56,2,50,1081,1133,-52
56,2,51,1139,1145,-6
56,2,52,1108,971,137
56,2,53,1118,864,254
56,2,54,1171,933,238
56,2,55,1021,831,190
56,2,56,994,820,174
56,2,57,1036,949,87
56,2,58,1193,833,360
56,2,59,1259,838,421
56,2,61,1393,1333,60
56,2,62,1198,1085,113
56,2,63,1015,861,154
56,2,64,1027,1404,-377
56,2,65,1032,897,135
56,2,66,939,975,-36
56,2,68,1016,1098,-82
56,2,69,1102,982,120
56,2,70,1187,950,237
56,2,71,1082,1013,69
56,2,72,987,862,125
57,1,1,979,1140,-161
57,1,2,906,1104,-198
57,1,3,882,953,-71
57,1,4,868,1014,-146
57,1,5,896,1017,-121
57,1,6,866,974,-108
57,1,7,934,1046,-112
57,1,8,876,1042,-166
57,1,9,826,938,-112
57,1,10,800,881,-81
57,1,11,755,875,-120
57,1,12,890,577,313
57,1,13,1013,920,93
57,1,14,951,951,0
57,1,15,917,453,464
57,1,16,832,861,-29
57,1,18,994,895,99
57,1,19,924,316,608
57,1,22,909,374,535
57,1,24,775,354,421
57,1,25,812,396,416
57,1,27,792,314,478
57,1,28,750,286,464
57,1,29,562,77,485
57,1,30,732,246,486
57,1,31,732,140,592
57,1,32,762,362,400
57,1,33,593,331,262
57,1,34,805,135,670
57,1,36,693,200,493
57,1,37,408,52,356
57,1,38,809,131,678
57,1,39,640,60,580
57,1,40,690,46,644
57,1,41,626,165,461
57,1,42,648,66,582
57,1,43,546,142,404
57,1,44,536,178,358
57,1,45,672,74,598
57,1,46,597,231,366
57,1,47,799,136,663
57,1,48,596,108,488
57,1,50,607,112,495
57,1,51,850,37,813
57,1,53,572,140,432
57,1,54,627,90,537
57,1,55,517,145,372
57,1,56,548,47,501
57,1,57,63,108,-45
57,1,58,891,52,839
57,1,59,700,130,570
57,1,60,87,129,-42
57,1,61,772,52,720
57,1,62,606,133,473
57,1,63,488,2,486
57,1,64,776,107,669
57,1,65,108,105,3
57,1,68,454,128,326
57,1,69,522,82,440
57,1,70,564,73,491
57,1,71,365,131,234
57,1,72,755,71,684
58,3,1,897,1343,-446
58,3,2,1066,978,88
58,3,3,979,905,74
58,3,4,912,1096,-184
58,3,5,976,1003,-27
58,3,6,930,837,93
58,3,7,903,922,-19
58,3,8,955,1046,-91
58,3,9,1087,1116,-29
58,3,10,1068,1147,-79
58,3,11,822,1041,-219
58,3,12,974,886,88
58,3,13,1035,916,119
58,3,14,848,1351,-503
58,3,15,836,856,-20
58,3,16,948,1090,-142
58,3,17,815,948,-133
58,3,18,846,925,-79
58,3,19,812,911,-99
58,3,20,1065,561,504
58,3,21,845,911,-66
58,3,22,761,866,-105
58,3,23,867,1002,-135
58,3,24,842,579,263
58,3,25,1266,960,306
58,3,26,860,1006,-146
58,3,27,920,1016,-96
58,3,28,918,905,13
58,3,29,933,932,1
58,3,30,986,942,44
58,3,31,785,989,-204
58,3,32,912,949,-37
58,3,33,856,948,-92
58,3,34,911,963,-52
58,3,35,849,881,-32
58,3,36,906,914,-8
58,3,37,845,884,-39
58,3,38,807,869,-62
58,3,39,998,988,10
58,3,40,798,1015,-217
58,3,41,797,871,-74
58,3,42,785,813,-28
58,3,43,968,841,127
58,3,44,566,563,3
58,3,45,748,1214,-466
58,3,46,826,717,109
58,3,47,966,964,2
58,3,48,1026,966,60
58,3,49,967,1292,-325
58,3,50,814,1340,-526
58,3,51,837,933,-96
58,3,52,881,1014,-133
58,3,53,1092,1295,-203
58,3,54,948,1000,-52
58,3,55,1166,942,224
58,3,56,872,1075,-203
58,3,57,872,894,-22
58,3,58,872,1046,-174
58,3,59,935,1001,-66
58,3,60,913,905,8
58,3,61,917,1018,-101
58,3,62,985,1095,-110
58,3,63,1055,1101,-46
58,3,64,972,1388,-416
58,3,65,841,903,-62
58,3,66,1217,824,393
58,3,67,822,787,35
58,3,68,957,1223,-266
58,3,69,933,1468,-535
58,3,70,974,858,116
58,3,71,1008,924,84
59,2,1,860,1000,-140
59,2,2,890,988,-98
59,2,3,852,795,57
59,2,4,892,734,158
59,2,5,764,838,-74
59,2,6,811,685,126
59,2,7,799,827,-28
59,2,8,703,704,-1
59,2,9,796,884,-88
59,2,10,798,701,97
59,2,12,926,733,193
59,2,13,788,698,90
59,2,14,789,694,95
59,2,15,808,617,191
59,2,16,1200,1098,102
59,2,17,964,1025,-61
59,2,18,728,1139,-411
59,2,19,785,1012,-227
59,2,20,891,953,-62
59,2,21,844,1011,-167
59,2,22,851,1000,-149
59,2,23,690,1186,-496
59,2,24,781,714,67
59,2,25,730,744,-14
59,2,26,896,851,45
59,2,27,1087,1218,-131
59,2,28,865,834,31
59,2,29,1083,726,357
59,2,30,715,1094,-379
59,2,31,792,818,-26
59,2,32,847,783,64
59,2,33,783,752,31
59,2,34,744,737,7
59,2,35,776,922,-146
59,2,36,704,910,-206
59,2,37,731,717,14
59,2,38,906,792,114
59,2,39,1337,611,726
59,2,40,689,608,81
59,2,41,677,635,42
59,2,42,809,701,108
59,2,43,714,1227,-513
59,2,44,853,797,56
59,2,45,785,714,71
59,2,46,1080,794,286
59,2,47,766,814,-48
59,2,48,804,652,152
59,2,49,717,930,-213
59,2,50,725,751,-26
59,2,51,663,1084,-421
59,2,52,744,633,111
59,2,53,675,589,86
59,2,54,670,603,67
59,2,55,729,1218,-489
59,2,56,937,1034,-97
59,2,57,724,763,-39
59,2,58,1003,677,326
59,2,59,905,1150,-245
59,2,60,1158,734,424
59,2,61,635,1030,-395
59,2,62,778,643,135
59,2,63,685,719,-34
59,2,64,697,707,-10
59,2,65,805,893,-88
59,2,66,836,1134,-298
59,2,67,839,1312,-473
59,2,68,763,1036,-273
59,2,70,731,824,-93
59,2,71,807,669,138
59,2,72,773,616,157
60,1,1,913,1147,-234
60,1,2,919,964,-45
60,1,3,794,891,-97
60,1,4,958,1017,-59
60,1,5,927,898,29
60,1,6,959,1017,-58
60,1,7,942,843,99
60,1,8,1011,824,187
60,1,9,894,889,5
60,1,10,1040,799,241
60,1,11,890,805,85
60,1,12,999,1123,-124
60,1,13,1573,746,827
60,1,14,825,707,118
60,1,15,853,709,144
60,1,16,924,925,-1
60,1,17,819,714,105
60,1,18,862,812,50
60,1,19,1204,836,368
60,1,20,950,785,165
60,1,21,1274,989,285
60,1,22,865,794,71
60,1,23,826,818,8
60,1,24,865,747,118
60,1,25,828,746,82
60,1,26,953,794,159
60,1,27,1118,767,351
60,1,28,783,988,-205
60,1,29,842,772,70
60,1,30,837,750,87
60,1,31,894,828,66
60,1,32,903,836,67
60,1,33,1164,758,406
60,1,34,821,791,30
60,1,35,1003,707,296
60,1,36,798,782,16
60,1,37,1132,790,342
60,1,38,822,775,47
60,1,39,834,751,83
60,1,40,713,654,59
60,1,41,828,759,69
60,1,42,809,692,117
60,1,44,908,757,151
60,1,45,791,804,-13
60,1,46,941,787,154
60,1,48,817,878,-61
60,1,49,952,785,167
60,1,50,974,874,100
60,1,52,802,703,99
60,1,53,848,763,85
60,1,54,945,835,110
60,1,55,970,984,-14
60,1,56,947,753,194
60,1,57,1252,800,452
60,1,58,1000,713,287
60,1,59,865,756,109
60,1,60,914,791,123
60,1,61,1021,785,236
60,1,62,1050,703,347
60,1,63,849,684,165
60,1,64,915,791,124
60,1,65,920,1157,-237
60,1,66,889,645,244
60,1,67,838,864,-26
60,1,68,879,699,180
60,1,69,775,657,118
60,1,70,794,705,89
60,1,71,882,737,145
60,1,72,818,804,14
61,1,1,1020,1167,-147
61,1,2,962,1150,-188
61,1,3,904,1255,-351
61,1,4,858,1061,-203
61,1,5,862,1020,-158
61,1,6,916,976,-60
61,1,7,992,1115,-123
61,1,8,994,1000,-6
61,1,9,858,1086,-228
61,1,10,893,913,-20
61,1,11,867,902,-35
61,1,13,1277,1017,260
61,1,14,898,1064,-166
61,1,15,967,1029,-62
61,1,16,850,844,6
61,1,17,535,842,-307
61,1,18,841,1060,-219
61,1,19,771,825,-54
61,1,20,841,598,243
61,1,21,980,649,331
61,1,22,840,1117,-277
61,1,23,872,566,306
61,1,24,880,510,370
61,1,25,1090,439,651
61,1,27,856,563,293
61,1,28,778,582,196
61,1,29,807,897,-90
61,1,30,833,628,205
61,1,31,860,590,270
61,1,32,966,364,602
61,1,33,852,784,68
61,1,34,754,550,204
61,1,35,940,455,485
61,1,36,941,384,557
61,1,37,844,401,443
61,1,38,1203,792,411
61,1,40,826,159,667
61,1,41,1062,786,276
61,1,43,817,303,514
61,1,45,1035,272,763
61,1,46,821,425,396
61,1,48,912,623,289
61,1,49,1099,87,1012
61,1,50,842,353,489
61,1,51,866,661,205
61,1,52,814,547,267
61,1,53,814,355,459
61,1,54,820,703,117
61,1,56,866,423,443
61,1,57,892,377,515
61,1,58,872,470,402
61,1,59,894,395,499
61,1,60,907,377,530
61,1,61,870,426,444
61,1,62,999,520,479
61,1,63,944,852,92
61,1,64,933,351,582
61,1,65,940,600,340
61,1,66,852,410,442
61,1,67,1012,409,603
61,1,68,935,611,324
61,1,69,1003,463,540
61,1,70,921,592,329
61,1,71,870,324,546
61,1,72,866,247,619
62,1,1,927,1063,-136
62,1,2,890,779,111
62,1,3,903,987,-84
62,1,4,892,860,32
62,1,5,882,681,201
62,1,6,846,759,87
62,1,7,863,630,233
62,1,8,1004,1064,-60
62,1,9,888,959,-71
62,1,10,892,760,132
62,1,11,835,706,129
62,1,12,846,620,226
62,1,13,884,747,137
62,1,14,711,1551,-840
62,1,15,1223,1124,99
62,1,16,1394,1342,52
62,1,17,1459,685,774
62,1,18,749,765,-16
62,1,19,842,753,89
62,1,20,1026,865,161
62,1,21,853,716,137
62,1,22,744,647,97
62,1,23,700,838,-138
62,1,24,937,771,166
62,1,25,891,718,173
62,1,26,855,718,137
62,1,27,987,704,283
62,1,28,864,705,159
62,1,29,1287,989,298
62,1,32,765,653,112
62,1,33,786,654,132
62,1,35,791,687,104
62,1,36,790,637,153
62,1,37,787,691,96
62,1,38,789,671,118
62,1,39,741,676,65
62,1,40,872,729,143
62,1,41,789,627,162
62,1,42,929,674,255
62,1,43,939,727,212
62,1,44,843,674,169
62,1,45,891,707,184
62,1,46,802,771,31
62,1,47,1753,1023,730
62,1,48,781,719,62
62,1,49,749,694,55
62,1,50,698,648,50
62,1,51,812,781,31
62,1,52,792,726,66
62,1,53,794,667,127
62,1,54,733,655,78
62,1,55,824,710,114
62,1,56,755,638,117
62,1,57,691,692,-1
62,1,58,723,689,34
62,1,59,1223,797,426
62,1,60,1371,691,680
62,1,61,646,729,-83
62,1,62,715,707,8
62,1,64,727,637,90
62,1,65,791,720,71
62,1,66,989,719,270
62,1,67,779,787,-8
62,1,68,831,725,106
62,1,69,914,731,183
62,1,70,746,743,3
62,1,71,714,745,-31
62,1,72,830,605,225
63,3,1,1004,1269,-265
63,3,2,1019,1367,-348
63,3,3,963,974,-11
63,3,4,1060,820,240
63,3,5,810,911,-101
63,3,6,891,830,61
63,3,7,788,698,90
63,3,8,843,1131,-288
63,3,9,714,803,-89
63,3,10,820,750,70
63,3,11,770,701,69
63,3,12,831,817,14
63,3,14,897,723,174
63,3,15,852,757,95
63,3,16,698,789,-91
63,3,17,798,780,18
63,3,18,791,594,197
63,3,19,910,828,82
63,3,20,794,750,44
63,3,21,1488,1387,101
63,3,22,872,717,155
63,3,23,948,867,81
63,3,24,888,721,167
63,3,25,855,761,94
63,3,27,782,747,35
63,3,28,737,782,-45
63,3,29,1065,814,251
63,3,30,755,710,45
63,3,32,686,561,125
63,3,33,756,578,178
63,3,34,893,689,204
63,3,35,744,646,98
63,3,36,874,684,190
63,3,37,775,705,70
63,3,39,1299,652,647
63,3,40,789,686,103
63,3,41,809,743,66
63,3,42,732,679,53
63,3,43,595,653,-58
63,3,44,736,749,-13
63,3,45,881,698,183
63,3,46,757,715,42
63,3,47,820,779,41
63,3,48,898,767,131
63,3,49,717,774,-57
63,3,50,694,666,28
63,3,51,776,680,96
63,3,52,678,718,-40
63,3,53,785,737,48
63,3,54,834,698,136
63,3,55,757,697,60
63,3,56,716,741,-25
63,3,57,779,643,136
63,3,58,731,703,28
63,3,59,703,616,87
63,3,60,700,752,-52
63,3,61,863,831,32
63,3,62,700,721,-21
63,3,65,836,714,122
63,3,66,782,597,185
63,3,67,763,1180,-417
63,3,69,790,714,76
63,3,70,867,652,215
63,3,71,700,775,-75
63,3,72,908,727,181
64,3,1,981,1605,-624
64,3,3,1538,1452,86
64,3,4,1153,1576,-423
64,3,6,1246,1062,184
64,3,7,1038,1047,-9
64,3,9,1139,1323,-184
64,3,10,1272,1229,43
64,3,11,1072,1162,-90
64,3,12,1149,1140,9
64,3,14,989,1000,-11
64,3,15,1018,1500,-482
64,3,16,1279,1282,-3
64,3,17,1144,1145,-1
64,3,18,1222,1133,89
64,3,19,1093,1143,-50
64,3,20,1189,1016,173
64,3,21,1092,1219,-127
64,3,22,1010,1003,7
64,3,23,1091,1044,47
64,3,24,1173,1207,-34
64,3,25,1253,1004,249
64,3,26,1048,1156,-108
64,3,27,1059,1140,-81
64,3,28,1090,1027,63
64,3,29,1104,1494,-390
64,3,30,919,1100,-181
64,3,31,1116,1810,-694
64,3,32,1064,1079,-15
64,3,33,1104,1114,-10
64,3,34,1130,1204,-74
64,3,35,987,1155,-168
64,3,36,1056,1067,-11
64,3,37,1178,1205,-27
64,3,38,1180,1094,86
64,3,39,1169,1232,-63
64,3,40,1308,1047,261
64,3,41,1263,1122,141
64,3,42,1317,1158,159
64,3,43,1133,1058,75
64,3,44,1116,990,126
64,3,45,1059,1019,40
64,3,46,1065,1173,-108
64,3,47,1147,963,184
64,3,48,1086,1053,33
64,3,49,1069,1154,-85
64,3,50,1102,855,247
64,3,51,1063,1657,-594
64,3,52,1010,1168,-158
64,3,53,1226,1066,160
64,3,54,1220,1831,-611
64,3,55,1086,1080,6
64,3,56,1108,1723,-615
64,3,57,1329,1156,173
64,3,58,1204,1566,-362
64,3,59,1192,1070,122
64,3,60,1333,1353,-20
64,3,61,985,1084,-99
64,3,62,1175,1082,93
64,3,63,996,938,58
64,3,64,1073,1066,7
64,3,65,1026,934,92
64,3,66,1068,1273,-205
64,3,67,1107,1093,14
64,3,68,1292,1332,-40
64,3,69,1064,943,121
64,3,70,1038,1120,-82
64,3,71,1115,962,153
64,3,72,1186,1160,26
65,1,1,1012,1065,-53
65,1,2,990,1014,-24
65,1,3,1144,874,270
65,1,4,1078,1055,23
65,1,6,898,840,58
65,1,7,1085,1078,7
65,1,8,972,1111,-139
65,1,9,848,917,-69
65,1,10,948,1062,-114
65,1,11,955,867,88
65,1,13,877,815,62
65,1,14,795,783,12
65,1,15,1019,1007,12
65,1,16,852,1010,-158
65,1,17,766,846,-80
65,1,18,903,1000,-97
65,1,19,870,939,-69
65,1,20,797,911,-114
65,1,21,712,1143,-431
65,1,22,1022,720,302
65,1,23,931,1010,-79
65,1,24,717,808,-91
65,1,25,875,818,57
65,1,26,667,743,-76
65,1,27,930,893,37
65,1,28,685,840,-155
65,1,29,870,842,28
65,1,30,861,743,118
65,1,31,735,859,-124
65,1,32,1009,873,136
65,1,33,972,1073,-101
65,1,34,884,786,98
65,1,35,673,703,-30
65,1,36,892,799,93
65,1,37,848,748,100
65,1,38,848,1030,-182
65,1,39,829,793,36
65,1,40,805,680,125
65,1,41,848,785,63
65,1,42,729,766,-37
65,1,43,880,737,143
65,1,44,907,1029,-122
65,1,45,708,892,-184
65,1,46,806,849,-43
65,1,47,666,784,-118
65,1,48,740,720,20
65,1,49,806,737,69
65,1,50,845,850,-5
65,1,51,691,779,-88
65,1,52,683,789,-106
65,1,53,732,702,30
65,1,54,634,651,-17
65,1,55,675,791,-116
65,1,56,559,643,-84
65,1,57,786,833,-47
65,1,58,624,919,-295
65,1,59,597,794,-197
65,1,61,808,670,138
65,1,62,674,633,41
65,1,63,825,815,10
65,1,64,679,781,-102
65,1,65,913,830,83
65,1,66,807,748,59
65,1,67,731,749,-18
65,1,68,1017,951,66
65,1,69,766,684,82
65,1,70,825,717,108
65,1,71,799,855,-56
65,1,72,767,785,-18
66,3,1,974,1427,-453
66,3,2,847,1606,-759
66,3,3,931,1221,-290
66,3,4,856,1085,-229
66,3,5,898,1128,-230
66,3,6,874,1165,-291
66,3,7,867,1082,-215
66,3,8,779,1447,-668
66,3,9,885,1310,-425
66,3,10,1171,1162,9
66,3,11,779,1084,-305
66,3,12,902,1080,-178
66,3,13,869,918,-49
66,3,14,791,1012,-221
66,3,15,873,959,-86
66,3,16,823,914,-91
66,3,17,790,848,-58
66,3,18,1059,915,144
66,3,19,896,1130,-234
66,3,20,767,927,-160
66,3,21,953,1174,-221
66,3,22,1127,933,194
66,3,23,789,1050,-261
66,3,24,755,828,-73
66,3,25,914,1101,-187
66,3,28,811,928,-117
66,3,29,839,912,-73
66,3,30,985,1020,-35
66,3,31,776,926,-150
66,3,32,1093,933,160
66,3,33,869,906,-37
66,3,34,897,1253,-356
66,3,35,848,885,-37
66,3,36,1227,1031,196
66,3,37,774,1062,-288
66,3,38,773,1025,-252
66,3,39,744,848,-104
66,3,40,797,923,-126
66,3,41,901,973,-72
66,3,42,1508,1663,-155
66,3,43,796,833,-37
66,3,44,803,1065,-262
66,3,45,979,1189,-210
66,3,47,921,975,-54
66,3,48,887,1092,-205
66,3,49,834,953,-119
66,3,50,918,842,76
66,3,51,829,1710,-881
66,3,52,954,1237,-283
66,3,54,785,1789,-1004
66,3,55,833,978,-145
66,3,56,1208,1200,8
66,3,60,904,1054,-150
66,3,61,825,943,-118
66,3,62,756,896,-140
66,3,63,869,908,-39
66,3,64,850,907,-57
66,3,65,707,880,-173
66,3,66,776,837,-61
66,3,67,911,987,-76
66,3,68,791,975,-184
66,3,69,832,964,-132
66,3,70,884,855,29
67,3,1,958,1146,-188
67,3,2,942,1060,-118
67,3,3,1007,1159,-152
67,3,4,992,894,98
67,3,5,1002,903,99
67,3,6,916,949,-33
67,3,7,1015,902,113
67,3,8,1025,883,142
67,3,9,904,1318,-414
67,3,10,1030,992,38
67,3,11,791,883,-92
67,3,12,811,871,-60
67,3,13,896,1066,-170
67,3,14,918,896,22
67,3,15,986,740,246
67,3,16,877,887,-10
67,3,17,872,672,200
67,3,18,801,709,92
67,3,19,825,711,114
67,3,20,709,1022,-313
67,3,21,822,881,-59
67,3,22,781,754,27
67,3,23,779,703,76
67,3,24,730,678,52
67,3,25,800,770,30
67,3,26,754,637,117
67,3,27,671,642,29
67,3,28,770,700,70
67,3,29,781,702,79
67,3,30,1078,660,418
67,3,31,720,849,-129
67,3,32,693,677,16
67,3,33,662,586,76
67,3,34,736,673,63
67,3,35,924,714,210
67,3,36,629,1431,-802
67,3,37,971,636,335
67,3,38,847,706,141
67,3,39,847,718,129
67,3,40,748,778,-30
67,3,41,761,639,122
67,3,42,679,664,15
67,3,43,695,613,82
67,3,44,792,856,-64
67,3,45,810,654,156
67,3,46,792,683,109
67,3,47,681,765,-84
67,3,48,802,621,181
67,3,49,676,752,-76
67,3,50,851,884,-33
67,3,51,804,752,52
67,3,52,728,832,-104
67,3,53,881,798,83
67,3,54,681,890,-209
67,3,55,763,839,-76
67,3,56,728,661,67
67,3,57,829,713,116
67,3,58,723,660,63
67,3,59,783,755,28
67,3,60,728,847,-119
67,3,61,656,837,-181
67,3,62,941,718,223
67,3,63,635,881,-246
67,3,64,797,664,133
67,3,65,767,680,87
67,3,66,781,648,133
67,3,67,1094,1138,-44
67,3,68,749,701,48
67,3,69,711,930,-219
67,3,70,785,638,147
68,2,1,919,1229,-310
68,2,2,892,1209,-317
68,2,3,1014,1008,6
68,2,4,1011,991,20
68,2,5,1009,1021,-12
68,2,6,950,1038,-88
68,2,7,903,1023,-120
68,2,8,1069,1026,43
68,2,9,1041,1536,-495
68,2,10,1814,1407,407
68,2,12,1044,1202,-158
68,2,13,905,1051,-146
68,2,15,1761,1872,-111
68,2,16,961,1164,-203
68,2,17,995,1214,-219
68,2,18,987,1012,-25
68,2,19,875,1282,-407
68,2,20,1210,1224,-14
68,2,21,1012,1090,-78
68,2,22,930,1135,-205
68,2,23,842,964,-122
68,2,24,965,1245,-280
68,2,25,898,1056,-158
68,2,26,1086,1016,70
68,2,27,1205,1043,162
68,2,28,1034,1153,-119
68,2,29,859,1135,-276
68,2,30,887,975,-88
68,2,31,1056,910,146
68,2,32,1099,1410,-311
68,2,33,1166,1234,-68
68,2,34,1047,998,49
68,2,35,1143,1580,-437
68,2,36,1141,1444,-303
68,2,37,1337,1280,57
68,2,38,1089,1065,24
68,2,39,1206,964,242
68,2,40,1078,996,82
68,2,41,1035,1131,-96
68,2,42,1166,1022,144
68,2,43,1110,1175,-65
68,2,44,1218,1056,162
68,2,45,1123,1130,-7
68,2,46,1537,1099,438
68,2,47,1529,1082,447
68,2,48,1112,984,128
68,2,49,1282,1287,-5
68,2,50,1110,1194,-84
68,2,51,1046,1012,34
68,2,52,1047,1248,-201
68,2,53,982,1039,-57
68,2,54,1056,1159,-103
68,2,55,1014,960,54
68,2,56,1057,1131,-74
68,2,57,1146,938,208
68,2,58,949,1301,-352
68,2,59,898,1113,-215
68,2,60,903,1253,-350
68,2,61,1059,1050,9
68,2,62,953,1359,-406
68,2,63,970,1080,-110
68,2,64,899,1264,-365
68,2,65,1275,1039,236
68,2,66,1045,1068,-23
68,2,67,1021,1054,-33
68,2,68,966,983,-17
68,2,69,979,1001,-22
68,2,70,932,739,193
68,2,71,994,1340,-346
68,2,72,865,1365,-500
69,1,2,884,1622,-738
69,1,3,938,1089,-151
69,1,4,853,851,2
69,1,5,764,711,53
69,1,6,831,777,54
69,1,7,890,871,19
69,1,8,854,779,75
69,1,9,869,800,69
69,1,10,879,771,108
69,1,11,956,828,128
69,1,12,865,876,-11
69,1,13,910,786,124
69,1,14,788,687,101
69,1,15,689,709,-20
69,1,16,802,779,23
69,1,17,942,758,184
69,1,18,883,1167,-284
69,1,19,796,792,4
69,1,20,762,810,-48
69,1,21,841,861,-20
69,1,22,1242,821,421
69,1,23,801,754,47
69,1,24,832,849,-17
69,1,25,770,828,-58
69,1,26,816,845,-29
69,1,27,811,718,93
69,1,28,817,678,139
69,1,29,827,724,103
69,1,30,823,786,37
69,1,31,908,693,215
69,1,32,858,770,88
69,1,33,803,728,75
69,1,34,840,866,-26
69,1,37,777,775,2
69,1,38,830,777,53
69,1,39,855,793,62
69,1,40,797,697,100
69,1,41,710,755,-45
69,1,42,827,755,72
69,1,43,843,694,149
69,1,44,880,726,154
69,1,45,892,785,107
69,1,46,830,790,40
69,1,47,743,928,-185
69,1,48,851,722,129
69,1,49,715,785,-70
69,1,50,707,712,-5
69,1,51,848,696,152
69,1,52,766,830,-64
69,1,53,821,745,76
69,1,54,687,743,-56
69,1,55,787,726,61
69,1,56,856,697,159
69,1,57,805,732,73
69,1,58,818,764,54
69,1,59,853,799,54
69,1,60,900,849,51
69,1,61,699,783,-84
69,1,62,1115,887,228
69,1,63,794,714,80
69,1,64,765,934,-169
69,1,65,815,854,-39
69,1,66,777,708,69
69,1,67,765,792,-27
69,1,68,746,671,75
69,1,69,822,767,55
69,1,70,823,713,110
69,1,71,919,760,159
69,1,72,784,646,138
70,1,1,997,873,124
70,1,2,977,669,308
70,1,3,1067,626,441
70,1,4,801,844,-43
70,1,5,620,786,-166
70,1,6,689,642,47
70,1,7,918,1337,-419
70,1,8,664,835,-171
70,1,9,362,953,-591
70,1,10,721,645,76
70,1,12,650,683,-33
70,1,13,806,560,246
70,1,14,690,711,-21
70,1,15,668,302,366
70,1,16,626,283,343
70,1,18,775,312,463
70,1,19,644,440,204
70,1,20,656,178,478
70,1,21,677,277,400
70,1,22,645,320,325
70,1,23,637,560,77
70,1,24,671,244,427
70,1,25,769,785,-16
70,1,26,739,601,138
70,1,27,720,552,168
70,1,28,1380,348,1032
70,1,29,657,191,466
70,1,31,863,421,442
70,1,32,1055,139,916
70,1,33,1152,909,243
70,1,36,551,705,-154
70,1,37,1081,337,744
70,1,38,1160,819,341
70,1,39,1285,615,670
70,1,40,1010,604,406
70,1,41,931,173,758
70,1,42,588,139,449
70,1,43,568,329,239
70,1,45,580,156,424
70,1,46,551,363,188
70,1,47,649,518,131
70,1,48,1120,1114,6
70,1,49,1066,403,663
70,1,50,990,338,652
70,1,51,1080,178,902
70,1,52,1010,320,690
70,1,53,1044,71,973
70,1,54,1031,542,489
70,1,55,871,181,690
70,1,56,511,318,193
70,1,57,1021,50,971
70,1,58,1163,102,1061
70,1,59,631,278,353
70,1,60,852,324,528
70,1,61,679,283,396
70,1,62,1698,362,1336
70,1,63,805,368,437
70,1,65,1076,179,897
70,1,66,909,166,743
70,1,67,965,161,804
70,1,68,1183,143,1040
70,1,69,632,169,463
70,1,70,690,337,353
70,1,71,603,92,511
70,1,72,663,617,46
71,1,1,1115,913,202
71,1,2,795,1161,-366
71,1,3,806,1040,-234
71,1,4,791,955,-164
71,1,5,744,1056,-312
71,1,6,762,1012,-250
71,1,7,817,857,-40
71,1,8,707,999,-292
71,1,9,773,755,18
71,1,10,709,354,355
71,1,11,701,262,439
71,1,12,723,349,374
71,1,13,758,251,507
71,1,14,639,251,388
71,1,15,837,263,574
71,1,16,875,226,649
71,1,17,802,122,680
71,1,18,794,316,478
71,1,20,660,258,402
71,1,21,745,42,703
71,1,22,715,52,663
71,1,23,904,228,676
71,1,24,816,106,710
71,1,25,354,89,265
71,1,26,248,186,62
71,1,28,440,75,365
71,1,29,853,7,846
71,1,30,791,152,639
71,1,31,778,68,710
71,1,32,564,70,494
71,1,33,588,14,574
71,1,34,372,127,245
71,1,35,694,73,621
71,1,36,788,139,649
71,1,37,657,44,613
71,1,38,675,7,668
71,1,39,710,610,100
71,1,40,824,252,572
71,1,41,751,634,117
71,1,42,817,29,788
71,1,43,695,12,683
71,1,44,683,28,655
71,1,45,722,5,717
71,1,46,754,16,738
71,1,47,651,9,642
71,1,48,665,26,639
71,1,49,834,9,825
71,1,50,510,16,494
71,1,51,691,21,670
71,1,52,806,7,799
71,1,53,625,8,617
71,1,54,549,5,544
71,1,55,785,15,770
71,1,56,673,458,215
71,1,57,739,29,710
71,1,58,820,10,810
71,1,59,743,9,734
71,1,60,820,24,796
71,1,61,871,588,283
71,1,62,730,24,706
71,1,63,351,17,334
71,1,64,847,20,827
71,1,65,789,117,672
71,1,66,750,11,739
71,1,67,727,738,-11
71,1,68,661,6,655
71,1,69,868,29,839
71,1,70,722,4,718
71,1,71,706,19,687
71,1,72,700,28,672
72,2,1,1124,1285,-161
72,2,2,907,917,-10
72,2,3,865,1011,-146
72,2,4,892,854,38
72,2,5,943,905,38
72,2,6,956,1030,-74
72,2,7,856,1074,-218
72,2,8,925,1023,-98
72,2,9,795,837,-42
72,2,10,750,983,-233
72,2,12,800,985,-185
72,2,13,885,1055,-170
72,2,14,869,1166,-297
72,2,15,785,1065,-280
72,2,16,937,1284,-347
72,2,17,409,375,34
72,2,18,793,507,286
72,2,19,777,962,-185
72,2,21,765,990,-225
72,2,22,828,959,-131
72,2,23,893,436,457
72,2,24,790,615,175
72,2,25,954,541,413
72,2,26,971,662,309
72,2,27,1102,580,522
72,2,28,860,581,279
72,2,29,826,1009,-183
72,2,30,893,920,-27
72,2,31,856,866,-10
72,2,32,810,772,38
72,2,33,1144,531,613
72,2,34,917,807,110
72,2,35,1071,617,454
72,2,36,913,1043,-130
72,2,37,953,794,159
72,2,38,865,1008,-143
72,2,39,761,905,-144
72,2,40,772,909,-137
72,2,41,828,542,286
72,2,42,944,872,72
72,2,43,799,384,415
72,2,44,872,904,-32
72,2,45,772,876,-104
72,2,46,804,821,-17
72,2,47,920,916,4
72,2,48,971,961,10
72,2,49,809,756,53
72,2,50,782,863,-81
72,2,51,837,895,-58
72,2,53,1079,1023,56
72,2,54,794,859,-65
72,2,56,812,908,-96
72,2,57,1022,1127,-105
72,2,58,680,1146,-466
72,2,59,804,422,382
72,2,60,973,911,62
72,2,63,785,781,4
72,2,64,733,830,-97
72,2,65,764,774,-10
72,2,66,826,781,45
72,2,67,717,869,-152
72,2,68,851,858,-7
72,2,69,727,952,-225
72,2,70,1214,1063,151
72,2,71,238,209,29
72,2,72,920,840,80
73,1,2,890,1279,-389
73,1,3,995,1009,-14
73,1,4,1101,1417,-316
73,1,5,223,240,-17
73,1,6,259,362,-103
73,1,8,1170,1022,148
73,1,11,967,296,671
73,1,12,1029,390,639
73,1,13,947,420,527
73,1,14,1008,317,691
73,1,16,1231,553,678
73,1,17,1362,304,1058
73,1,19,603,284,319
73,1,20,1003,540,463
73,1,22,1120,156,964
73,1,23,607,169,438
73,1,24,1243,298,945
73,1,25,1041,304,737
73,1,26,850,540,310
73,1,27,1006,42,964
73,1,28,954,237,717
73,1,29,993,474,519
73,1,30,583,97,486
73,1,31,1001,499,502
73,1,33,1565,172,1393
73,1,34,1151,633,518
73,1,35,1202,322,880
73,1,36,1112,339,773
73,1,38,976,340,636
73,1,45,1205,292,913
73,1,48,1196,14,1182
74,3,1,822,1031,-209
74,3,2,715,1282,-567
74,3,3,881,802,79
74,3,4,828,783,45
74,3,5,752,689,63
74,3,6,848,832,16
74,3,7,837,796,41
74,3,8,759,858,-99
74,3,9,826,700,126
74,3,10,759,802,-43
74,3,11,795,694,101
74,3,12,811,889,-78
74,3,13,811,541,270
74,3,14,788,742,46
74,3,15,747,870,-123
74,3,16,777,722,55
74,3,17,682,721,-39
74,3,18,736,722,14
74,3,19,838,676,162
74,3,20,787,749,38
74,3,21,781,741,40
74,3,22,750,690,60
74,3,23,843,750,93
74,3,24,696,906,-210
74,3,26,796,872,-76
74,3,27,821,727,94
74,3,28,766,767,-1
74,3,29,769,670,99
74,3,31,733,672,61
74,3,32,673,644,29
74,3,33,687,641,46
74,3,34,705,820,-115
74,3,35,744,700,44
74,3,36,770,624,146
74,3,38,634,618,16
74,3,39,793,682,111
74,3,40,781,613,168
74,3,42,746,763,-17
74,3,43,858,630,228
74,3,44,783,866,-83
74,3,45,704,673,31
74,3,46,759,784,-25
74,3,47,668,668,0
74,3,48,905,698,207
74,3,49,787,876,-89
74,3,50,758,408,350
74,3,51,676,388,288
74,3,52,702,400,302
74,3,54,738,395,343
74,3,55,731,414,317
74,3,56,660,413,247
74,3,57,833,539,294
74,3,58,702,462,240
74,3,59,785,493,292
74,3,60,687,440,247
74,3,61,719,393,326
74,3,62,653,472,181
74,3,63,792,499,293
74,3,64,886,422,464
74,3,65,734,429,305
74,3,66,707,236,471
74,3,67,687,363,324
74,3,68,703,427,276
74,3,69,800,441,359
74,3,70,680,393,287
74,3,71,772,470,302
74,3,72,707,381,326
75,3,1,1036,1122,-86
75,3,2,1079,1062,17
75,3,3,1112,1189,-77
75,3,4,992,1027,-35
75,3,5,909,921,-12
75,3,6,1023,949,74
75,3,7,1068,1282,-214
75,3,8,1069,1394,-325
75,3,9,1101,966,135
75,3,10,922,1018,-96
75,3,11,938,1008,-70
75,3,12,955,986,-31
75,3,13,946,971,-25
75,3,14,991,862,129
75,3,15,1004,1058,-54
75,3,16,1158,1095,63
75,3,17,929,977,-48
75,3,18,879,961,-82
75,3,19,1070,958,112
75,3,20,1074,1057,17
75,3,21,870,925,-55
75,3,22,889,986,-97
75,3,23,990,954,36
75,3,24,903,973,-70
75,3,25,1203,938,265
75,3,26,892,953,-61
75,3,27,1020,897,123
75,3,28,916,959,-43
75,3,29,936,932,4
75,3,30,938,1218,-280
75,3,31,903,842,61
75,3,32,932,1044,-112
75,3,33,959,824,135
75,3,34,861,954,-93
75,3,35,930,924,6
75,3,36,876,813,63
75,3,37,883,874,9
75,3,38,936,947,-11
75,3,39,877,920,-43
75,3,40,907,770,137
75,3,41,883,936,-53
75,3,42,860,867,-7
75,3,43,875,865,10
75,3,44,937,885,52
75,3,45,880,841,39
75,3,46,904,945,-41
75,3,47,828,845,-17
75,3,48,995,832,163
75,3,49,814,809,5
75,3,50,865,802,63
75,3,51,800,877,-77
75,3,52,825,859,-34
75,3,53,831,878,-47
75,3,54,838,859,-21
75,3,55,900,898,2
75,3,56,883,919,-36
75,3,57,816,892,-76
75,3,59,863,998,-135
75,3,60,864,800,64
75,3,61,816,787,29
75,3,62,897,945,-48
75,3,63,939,816,123
75,3,64,915,952,-37
75,3,65,968,1014,-46
75,3,66,865,879,-14
75,3,67,910,946,-36
75,3,68,851,935,-84
75,3,69,882,989,-107
75,3,70,938,863,75
75,3,71,856,846,10
75,3,72,1014,975,39
76,2,1,1172,1411,-239
76,2,2,1099,1370,-271
76,2,3,1241,1434,-193
76,2,4,1248,1299,-51
76,2,5,1187,1389,-202
76,2,6,1222,1363,-141
76,2,7,1197,1139,58
76,2,8,1169,1112,57
76,2,9,1252,1231,21
76,2,10,1116,1114,2
76,2,11,1186,1314,-128
76,2,13,1195,1057,138
76,2,14,1099,1170,-71
76,2,15,1159,1181,-22
76,2,16,1077,1065,12
76,2,17,1184,1197,-13
76,2,18,1227,1114,113
76,2,19,1186,1268,-82
76,2,20,1157,1272,-115
76,2,21,1112,1161,-49
76,2,22,1122,1177,-55
76,2,23,1181,1144,37
76,2,24,1107,1193,-86
76,2,25,1048,1102,-54
76,2,26,1000,987,13
76,2,27,1085,1073,12
76,2,28,985,1025,-40
76,2,29,1081,1067,14
76,2,30,1076,1052,24
76,2,31,1116,1180,-64
76,2,32,1054,1080,-26
76,2,33,1069,1032,37
76,2,34,1094,1017,77
76,2,35,1116,1080,36
76,2,36,1113,1095,18
76,2,37,1425,1142,283
76,2,38,1163,1041,122
76,2,39,1209,1127,82
76,2,40,1154,1087,67
76,2,41,1170,1194,-24
76,2,42,1141,1087,54
76,2,43,1171,1168,3
76,2,44,1117,1089,28
76,2,45,1208,1043,165
76,2,46,1091,1035,56
76,2,47,1191,1087,104
76,2,48,1175,1130,45
76,2,49,1120,1016,104
76,2,50,1164,1090,74
76,2,51,1126,1058,68
76,2,52,1216,1183,33
76,2,53,1163,1038,125
76,2,54,1143,1164,-21
76,2,55,1142,1176,-34
76,2,56,1173,1295,-122
76,2,57,1104,1064,40
76,2,58,1137,1351,-214
76,2,59,1146,1052,94
76,2,60,1148,1085,63
76,2,61,1110,1081,29
76,2,62,1160,993,167
76,2,63,1173,1062,111
76,2,64,1112,1030,82
76,2,65,1258,1167,91
76,2,66,1132,1082,50
76,2,67,1142,1192,-50
76,2,68,1068,993,75
76,2,69,1303,1153,150
76,2,70,1143,1096,47
76,2,71,1108,1173,-65
76,2,72,1167,1056,111
77,3,1,802,1214,-412
77,3,2,856,1011,-155
77,3,3,828,792,36
77,3,4,875,983,-108
77,3,5,891,871,20
77,3,6,833,814,19
77,3,7,845,777,68
77,3,8,808,868,-60
77,3,9,841,885,-44
77,3,10,813,761,52
77,3,11,820,817,3
77,3,12,829,841,-12
77,3,13,862,746,116
77,3,14,857,726,131
77,3,15,805,1186,-381
77,3,16,784,781,3
77,3,17,754,669,85
77,3,18,1053,679,374
77,3,19,851,639,212
77,3,20,815,699,116
77,3,21,863,715,148
77,3,22,741,1201,-460
77,3,23,742,802,-60
77,3,24,915,735,180
77,3,25,785,751,34
77,3,26,708,624,84
77,3,27,746,680,66
77,3,28,711,581,130
77,3,29,725,640,85
77,3,30,781,1051,-270
77,3,31,783,699,84
77,3,32,783,748,35
77,3,33,812,728,84
77,3,34,840,708,132
77,3,35,858,678,180
77,3,36,859,696,163
77,3,38,713,1142,-429
77,3,39,821,738,83
77,3,40,759,676,83
77,3,41,777,711,66
77,3,42,763,712,51
77,3,45,887,1139,-252
77,3,48,742,658,84
77,3,50,1000,646,354
77,3,51,703,652,51
77,3,53,734,634,100
77,3,54,820,898,-78
77,3,55,787,960,-173
77,3,56,1036,839,197
77,3,58,800,733,67
77,3,59,764,906,-142
77,3,60,740,721,19
77,3,61,907,855,52
77,3,64,745,806,-61
77,3,65,716,712,4
77,3,66,766,571,195
77,3,67,875,823,52
77,3,68,807,884,-77
77,3,69,832,950,-118
77,3,70,870,835,35
77,3,71,1070,1082,-12
77,3,72,801,765,36
78,3,1,918,1108,-190
78,3,2,895,905,-10
78,3,3,816,820,-4
78,3,4,891,892,-1
78,3,5,850,737,113
78,3,6,851,680,171
78,3,7,822,917,-95
78,3,8,820,869,-49
78,3,9,778,718,60
78,3,10,744,769,-25
78,3,11,819,709,110
78,3,12,843,804,39
78,3,13,899,729,170
78,3,14,703,759,-56
78,3,15,768,743,25
78,3,16,783,880,-97
78,3,17,809,681,128
78,3,18,735,622,113
78,3,19,697,707,-10
78,3,20,727,842,-115
78,3,21,893,732,161
78,3,22,773,712,61
78,3,23,788,802,-14
78,3,24,680,720,-40
78,3,25,697,600,97
78,3,26,708,737,-29
78,3,27,751,820,-69
78,3,28,749,860,-111
78,3,29,680,665,15
78,3,30,693,688,5
78,3,31,678,790,-112
78,3,32,760,704,56
78,3,33,730,743,-13
78,3,34,820,820,0
78,3,35,730,773,-43
78,3,36,933,737,196
78,3,37,776,755,21
78,3,38,739,694,45
78,3,39,727,732,-5
78,3,40,708,811,-103
78,3,41,692,740,-48
78,3,42,726,889,-163
78,3,43,781,776,5
78,3,44,810,766,44
78,3,45,744,701,43
78,3,46,715,701,14
78,3,47,768,704,64
78,3,48,730,663,67
78,3,49,886,760,126
78,3,50,837,807,30
78,3,51,810,857,-47
78,3,52,756,698,58
78,3,53,741,687,54
78,3,54,750,700,50
78,3,55,729,630,99
78,3,56,787,694,93
78,3,57,792,817,-25
78,3,58,770,761,9
78,3,59,759,827,-68
78,3,60,738,669,69
78,3,61,836,717,119
78,3,62,678,747,-69
78,3,63,831,866,-35
78,3,64,971,851,120
78,3,65,759,857,-98
78,3,66,721,668,53
78,3,67,794,835,-41
78,3,68,956,1033,-77
78,3,69,668,710,-42
78,3,70,905,676,229
78,3,71,710,644,66
78,3,72,714,657,57
79,2,1,1078,1317,-239
79,2,2,1078,1324,-246
79,2,3,988,1262,-274
79,2,4,1072,1159,-87
79,2,5,1159,1108,51
79,2,6,1228,1351,-123
79,2,7,1050,1321,-271
79,2,8,1019,1050,-31
79,2,9,1062,1202,-140
79,2,10,1100,1167,-67
79,2,11,1017,1098,-81
79,2,12,1143,1110,33
79,2,13,1123,1142,-19
79,2,14,1090,1366,-276
79,2,15,1092,1042,50
79,2,16,1058,1213,-155
79,2,17,1045,1054,-9
79,2,18,968,1083,-115
79,2,19,1008,1093,-85
79,2,20,1011,1030,-19
79,2,21,964,1138,-174
79,2,22,1141,1169,-28
79,2,23,1038,982,56
79,2,24,999,1180,-181
79,2,25,1153,1060,93
79,2,26,1594,1073,521
79,2,27,1103,1162,-59
79,2,28,1223,1148,75
79,2,29,1032,1115,-83
79,2,30,1123,1094,29
79,2,31,1025,1213,-188
79,2,32,830,1206,-376
79,2,33,1029,886,143
79,2,34,946,966,-20
79,2,35,873,850,23
79,2,36,1043,825,218
79,2,37,1059,1206,-147
79,2,39,1182,1199,-17
79,2,40,1021,1217,-196
79,2,41,1118,1329,-211
79,2,42,1123,1117,6
79,2,43,1081,1307,-226
79,2,44,1456,1161,295
79,2,45,1056,1069,-13
79,2,46,998,1026,-28
79,2,47,1001,1060,-59
79,2,48,1214,1057,157
79,2,49,1022,1015,7
79,2,50,1328,1256,72
79,2,51,1175,1232,-57
79,2,52,1132,1125,7
79,2,53,1111,1208,-97
79,2,54,998,1332,-334
79,2,55,943,1077,-134
79,2,56,1038,1229,-191
79,2,57,980,1239,-259
79,2,58,1027,1370,-343
79,2,59,1067,1174,-107
79,2,60,951,1096,-145
79,2,61,1332,1064,268
79,2,62,1020,1132,-112
79,2,63,992,1062,-70
79,2,64,973,1072,-99
79,2,65,1065,1029,36
79,2,66,1055,1003,52
79,2,67,1214,1130,84
79,2,68,1033,1031,2
79,2,69,1102,1049,53
79,2,70,985,1131,-146
79,2,71,1039,1030,9
79,2,72,950,1072,-122
80,3,2,864,872,-8
80,3,3,768,835,-67
80,3,4,754,829,-75
80,3,5,731,882,-151
80,3,6,709,770,-61
80,3,7,767,1065,-298
80,3,8,674,814,-140
80,3,9,760,721,39
80,3,10,672,909,-237
80,3,11,757,727,30
80,3,12,823,981,-158
80,3,13,1580,939,641
80,3,14,709,794,-85
80,3,15,769,890,-121
80,3,17,1090,1011,79
80,3,18,660,658,2
80,3,19,720,663,57
80,3,20,680,685,-5
80,3,21,680,798,-118
80,3,22,686,694,-8
80,3,23,736,779,-43
80,3,24,756,741,15
80,3,25,755,754,1
80,3,26,771,721,50
80,3,27,715,701,14
80,3,28,788,785,3
80,3,29,661,817,-156
80,3,30,850,745,105
80,3,31,798,703,95
80,3,33,734,889,-155
80,3,34,842,828,14
80,3,35,754,772,-18
80,3,36,1118,762,356
80,3,37,766,775,-9
80,3,38,796,741,55
80,3,39,716,742,-26
80,3,40,802,694,108
80,3,41,813,658,155
80,3,42,733,653,80
80,3,43,1110,793,317
80,3,44,838,752,86
80,3,45,674,686,-12
80,3,46,714,867,-153
80,3,47,778,750,28
80,3,48,842,697,145
80,3,49,892,667,225
80,3,50,786,748,38
80,3,51,1407,933,474
80,3,52,1149,1005,144
80,3,53,733,679,54
80,3,54,1003,892,111
80,3,55,842,1178,-336
80,3,56,880,827,53
80,3,57,725,804,-79
80,3,58,886,609,277
80,3,59,887,773,114
80,3,60,760,853,-93
80,3,64,1179,869,310
80,3,65,1061,981,80
80,3,66,1107,761,346
80,3,67,788,689,99
80,3,68,883,811,72
80,3,69,769,799,-30
80,3,70,896,959,-63
80,3,71,715,644,71
80,3,72,819,751,68
81,2,1,1062,1233,-171
81,2,2,1125,1351,-226
81,2,3,1104,1113,-9
81,2,4,970,1109,-139
81,2,5,913,1253,-340
81,2,6,908,1108,-200
81,2,7,1082,996,86
81,2,8,982,1240,-258
81,2,9,931,1042,-111
81,2,10,916,982,-66
81,2,11,1114,1218,-104
81,2,12,897,1184,-287
81,2,13,837,1034,-197
81,2,14,967,1203,-236
81,2,15,997,1127,-130
81,2,16,852,1058,-206
81,2,17,963,1013,-50
81,2,18,921,1064,-143
81,2,19,848,1066,-218
81,2,20,978,1100,-122
81,2,21,1258,1188,70
81,2,22,932,1002,-70
81,2,23,925,890,35
81,2,24,914,1018,-104
81,2,25,978,1159,-181
81,2,26,842,1048,-206
81,2,27,1001,1371,-370
81,2,28,841,972,-131
81,2,29,918,990,-72
81,2,30,843,951,-108
81,2,31,853,1021,-168
81,2,32,888,928,-40
81,2,33,892,1095,-203
81,2,34,961,974,-13
81,2,35,915,1033,-118
81,2,36,965,1043,-78
81,2,37,870,1237,-367
81,2,38,856,1069,-213
81,2,39,853,1054,-201
81,2,40,908,1013,-105
81,2,41,971,1017,-46
81,2,42,902,1010,-108
81,2,43,1012,912,100
81,2,44,1041,1161,-120
81,2,45,969,997,-28
81,2,46,927,1142,-215
81,2,47,959,1110,-151
81,2,48,905,959,-54
81,2,49,1462,1085,377
81,2,50,1061,1168,-107
81,2,51,920,1042,-122
81,2,52,973,958,15
81,2,53,935,987,-52
81,2,54,977,944,33
81,2,55,1000,1110,-110
81,2,56,920,1017,-97
81,2,57,1414,1125,289
81,2,58,1072,1043,29
81,2,59,1155,1151,4
81,2,60,981,1108,-127
81,2,61,1008,966,42
81,2,62,877,868,9
81,2,63,937,1227,-290
81,2,64,1115,1031,84
81,2,65,1065,983,82
81,2,66,886,1026,-140
81,2,67,903,1160,-257
81,2,68,1031,1016,15
81,2,69,1062,1010,52
81,2,70,1060,1017,43
81,2,71,890,1052,-162
81,2,72,933,1042,-109
82,1,1,1124,1268,-144
82,1,2,1050,1079,-29
82,1,3,963,1106,-143
82,1,4,1019,1031,-12
82,1,5,862,1104,-242
82,1,6,838,967,-129
82,1,7,1111,1026,85
82,1,8,368,34,334
82,1,9,946,96,850
82,1,10,1023,331,692
82,1,11,783,57,726
82,1,12,760,163,597
82,1,13,777,103,674
82,1,14,901,456,445
82,1,15,831,259,572
82,1,16,779,381,398
82,1,17,720,219,501
82,1,18,847,563,284
82,1,19,1016,122,894
82,1,20,872,332,540
82,1,21,770,181,589
82,1,22,950,364,586
82,1,23,822,126,696
82,1,24,771,468,303
82,1,25,890,306,584
82,1,28,850,7,843
82,1,29,735,131,604
82,1,30,774,128,646
82,1,31,588,214,374
82,1,32,607,60,547
82,1,33,573,352,221
82,1,35,584,106,478
82,1,36,813,62,751
82,1,37,897,45,852
82,1,38,793,91,702
82,1,39,698,1,697
82,1,40,787,149,638
82,1,41,734,136,598
82,1,42,661,206,455
82,1,43,883,115,768
82,1,44,903,31,872
82,1,45,717,189,528
82,1,46,740,39,701
82,1,47,810,355,455
82,1,48,833,406,427
82,1,49,746,118,628
82,1,50,703,185,518
82,1,51,627,239,388
82,1,52,623,417,206
82,1,53,748,222,526
82,1,54,653,272,381
82,1,55,900,136,764
82,1,56,776,195,581
82,1,57,880,153,727
82,1,58,852,207,645
82,1,59,782,163,619
82,1,60,758,119,639
82,1,61,1509,261,1248
82,1,62,714,484,230
82,1,63,779,304,475
82,1,64,1001,92,909
82,1,65,822,696,126
82,1,66,723,215,508
82,1,67,589,296,293
82,1,68,258,94,164
82,1,69,664,43,621
82,1,70,646,107,539
82,1,71,820,318,502
82,1,72,757,353,404
83,1,1,1068,1098,-30
83,1,2,964,879,85
83,1,3,995,769,226
83,1,4,970,769,201
83,1,5,920,837,83
83,1,6,1036,716,320
83,1,7,1094,900,194
83,1,8,1024,879,145
83,1,9,962,1061,-99
83,1,10,991,1105,-114
83,1,11,892,876,16
83,1,12,942,760,182
83,1,13,870,691,179
83,1,14,892,762,130
83,1,15,908,814,94
83,1,16,852,750,102
83,1,17,871,733,138
83,1,18,896,712,184
83,1,19,877,662,215
83,1,20,924,686,238
83,1,21,1056,673,383
83,1,22,1137,734,403
83,1,23,1145,856,289
83,1,24,1037,852,185
83,1,26,851,868,-17
83,1,27,1046,1076,-30
83,1,28,772,809,-37
83,1,29,1093,649,444
83,1,30,896,1173,-277
83,1,31,1211,880,331
83,1,32,1407,823,584
83,1,33,858,933,-75
83,1,34,949,891,58
84,3,1,942,1302,-360
84,3,2,1057,1352,-295
84,3,3,968,1209,-241
84,3,4,990,1234,-244
84,3,5,904,1264,-360
84,3,6,964,1572,-608
84,3,7,934,1064,-130
84,3,8,988,1072,-84
84,3,9,977,1233,-256
84,3,10,1073,1153,-80
84,3,11,851,1218,-367
84,3,12,1070,1080,-10
84,3,13,880,1035,-155
84,3,14,864,1064,-200
84,3,15,905,1080,-175
84,3,16,957,1108,-151
84,3,17,968,1233,-265
84,3,18,991,1161,-170
84,3,19,952,1106,-154
84,3,20,936,931,5
84,3,21,827,1067,-240
84,3,22,866,1047,-181
84,3,23,879,968,-89
84,3,24,1005,1317,-312
84,3,25,937,1089,-152
84,3,26,855,1097,-242
84,3,27,1457,922,535
84,3,28,933,979,-46
84,3,29,922,809,113
84,3,30,886,958,-72
84,3,31,844,1351,-507
84,3,32,866,1117,-251
84,3,33,922,1267,-345
84,3,34,892,1042,-150
84,3,35,827,893,-66
84,3,36,849,963,-114
84,3,37,914,905,9
84,3,38,1206,945,261
84,3,39,984,912,72
84,3,41,956,1149,-193
84,3,43,1046,1354,-308
84,3,44,1017,1329,-312
84,3,45,1056,1497,-441
84,3,46,839,950,-111
84,3,49,911,1044,-133
84,3,50,951,1004,-53
84,3,51,993,941,52
84,3,52,900,1610,-710
84,3,53,1029,1351,-322
84,3,54,951,1084,-133
84,3,55,893,1071,-178
84,3,56,965,1138,-173
84,3,57,1192,1029,163
84,3,58,1079,1183,-104
84,3,59,1081,979,102
84,3,60,909,879,30
84,3,61,1094,1077,17
84,3,62,982,910,72
84,3,63,1016,1112,-96
84,3,64,916,891,25
84,3,65,851,899,-48
84,3,66,923,1049,-126
84,3,67,1034,937,97
84,3,68,824,1028,-204
84,3,69,978,1002,-24
84,3,70,864,977,-113
84,3,71,913,1113,-200
84,3,72,920,920,0
85,1,1,766,990,-224
85,1,2,810,935,-125
85,1,3,864,711,153
85,1,4,743,490,253
85,1,5,697,689,8
85,1,6,817,747,70
85,1,7,849,727,122
85,1,8,699,780,-81
85,1,9,718,562,156
85,1,10,717,757,-40
85,1,11,726,653,73
85,1,12,772,674,98
85,1,13,1216,700,516
85,1,14,667,605,62
85,1,15,767,692,75
85,1,16,650,699,-49
85,1,17,764,809,-45
85,1,18,791,815,-24
85,1,19,721,1164,-443
85,1,20,690,641,49
85,1,21,1385,720,665
85,1,22,744,1236,-492
85,1,23,1041,1058,-17
85,1,24,683,707,-24
85,1,25,670,611,59
85,1,26,667,641,26
85,1,27,733,882,-149
85,1,28,802,546,256
85,1,29,876,568,308
85,1,30,717,721,-4
85,1,31,760,680,80
85,1,32,693,618,75
85,1,33,624,448,176
85,1,34,674,589,85
85,1,35,756,720,36
85,1,36,699,506,193
85,1,37,650,568,82
85,1,38,861,622,239
85,1,39,692,595,97
85,1,40,646,639,7
85,1,41,718,631,87
85,1,42,766,754,12
85,1,43,751,674,77
85,1,44,731,770,-39
85,1,45,721,735,-14
85,1,46,714,811,-97
85,1,47,802,639,163
85,1,48,731,718,13
85,1,49,751,500,251
85,1,50,718,641,77
85,1,51,684,815,-131
85,1,52,739,763,-24
85,1,53,699,745,-46
85,1,54,863,671,192
85,1,55,755,654,101
85,1,57,616,633,-17
85,1,58,744,680,64
85,1,59,712,480,232
85,1,60,1079,704,375
85,1,61,671,855,-184
85,1,62,709,673,36
85,1,63,738,739,-1
85,1,64,1027,492,535
85,1,65,599,666,-67
85,1,66,757,664,93
85,1,67,690,697,-7
85,1,68,665,984,-319
85,1,69,632,478,154
85,1,70,664,1078,-414
85,1,71,701,787,-86
85,1,72,752,635,117
86,2,2,913,808,105
86,2,3,849,973,-124
86,2,4,863,829,34
86,2,5,802,700,102
86,2,6,861,985,-124
86,2,7,713,754,-41
86,2,8,757,836,-79
86,2,9,1021,731,290
86,2,10,807,790,17
86,2,11,805,873,-68
86,2,12,824,727,97
86,2,13,906,728,178
86,2,14,716,756,-40
86,2,15,680,672,8
86,2,16,689,708,-19
86,2,17,860,636,224
86,2,18,716,812,-96
86,2,20,758,705,53
86,2,21,717,679,38
86,2,22,715,709,6
86,2,23,789,650,139
86,2,24,861,724,137
86,2,25,732,680,52
86,2,26,705,741,-36
86,2,27,760,646,114
86,2,28,853,669,184
86,2,29,723,675,48
86,2,30,786,691,95
86,2,31,762,734,28
86,2,32,799,746,53
86,2,33,682,651,31
86,2,34,999,682,317
86,2,35,770,680,90
86,2,36,746,721,25
86,2,37,724,703,21
86,2,38,780,698,82
86,2,39,731,673,58
86,2,40,708,681,27
86,2,41,733,586,147
86,2,43,692,663,29
86,2,44,899,684,215
86,2,45,744,720,24
86,2,46,751,638,113
86,2,47,732,715,17
86,2,48,708,720,-12
86,2,49,731,616,115
86,2,50,1037,632,405
86,2,51,905,680,225
86,2,52,791,931,-140
86,2,53,766,760,6
86,2,54,851,897,-46
86,2,55,1380,906,474
86,2,56,731,729,2
86,2,57,730,679,51
86,2,58,672,651,21
86,2,59,835,659,176
86,2,60,706,691,15
86,2,61,690,722,-32
86,2,62,667,761,-94
86,2,63,671,725,-54
86,2,64,713,859,-146
86,2,65,718,733,-15
86,2,66,770,873,-103
86,2,67,951,1018,-67
86,2,68,871,981,-110
86,2,69,1351,911,440
86,2,70,1195,866,329
86,2,71,955,901,54
86,2,72,955,991,-36
87,1,1,855,1217,-362
87,1,2,864,955,-91
87,1,3,974,948,26
87,1,4,898,1077,-179
87,1,5,989,992,-3
87,1,6,834,1205,-371
87,1,7,870,980,-110
87,1,8,877,1495,-618
87,1,9,864,435,429
87,1,10,861,352,509
87,1,11,848,267,581
87,1,12,1240,298,942
87,1,13,801,428,373
87,1,14,678,1050,-372
87,1,15,754,446,308
87,1,16,616,316,300
87,1,17,838,459,379
87,1,18,727,498,229
87,1,19,768,491,277
87,1,20,741,393,348
87,1,21,570,391,179
87,1,22,1017,656,361
87,1,23,756,551,205
87,1,24,772,413,359
87,1,25,878,531,347
87,1,26,660,440,220
87,1,27,712,761,-49
87,1,28,927,802,125
87,1,29,683,655,28
87,1,30,851,848,3
87,1,31,789,481,308
87,1,32,460,374,86
87,1,33,823,522,301
87,1,34,812,385,427
87,1,35,569,388,181
87,1,36,765,846,-81
87,1,37,800,267,533
87,1,39,718,401,317
87,1,40,828,432,396
87,1,41,859,390,469
87,1,42,750,513,237
87,1,43,777,379,398
87,1,44,770,427,343
87,1,45,995,541,454
87,1,46,894,761,133
87,1,48,804,446,358
87,1,49,800,499,301
87,1,51,792,427,365
87,1,52,768,618,150
87,1,53,769,804,-35
87,1,54,773,433,340
87,1,55,885,817,68
87,1,56,783,371,412
87,1,57,809,356,453
87,1,58,844,737,107
87,1,59,756,735,21
87,1,60,543,465,78
87,1,61,833,594,239
87,1,62,836,640,196
87,1,63,831,443,388
87,1,64,861,824,37
87,1,65,781,526,255
87,1,66,708,638,70
87,1,67,811,503,308
87,1,68,815,491,324
87,1,69,765,536,229
87,1,70,508,584,-76
87,1,71,845,498,347
87,1,72,897,482,415
88,1,1,960,1363,-403
88,1,2,851,1319,-468
88,1,5,873,997,-124
88,1,6,1424,990,434
88,1,7,862,849,13
88,1,8,827,1658,-831
88,1,9,874,1215,-341
88,1,10,856,1005,-149
88,1,11,956,943,13
88,1,12,870,1041,-171
88,1,13,942,1164,-222
88,1,14,857,1064,-207
88,1,15,894,1014,-120
88,1,16,1023,888,135
88,1,17,863,932,-69
88,1,19,936,1072,-136
88,1,20,821,1015,-194
88,1,21,841,878,-37
88,1,22,915,967,-52
88,1,23,961,1060,-99
88,1,24,936,933,3
88,1,25,998,977,21
88,1,26,871,889,-18
88,1,27,910,837,73
88,1,28,778,822,-44
88,1,29,741,790,-49
88,1,30,881,968,-87
88,1,32,875,1086,-211
88,1,33,860,791,69
88,1,34,965,1053,-88
88,1,35,1086,842,244
88,1,36,935,901,34
88,1,37,821,825,-4
88,1,38,816,922,-106
88,1,39,1014,919,95
88,1,40,831,770,61
88,1,41,836,972,-136
88,1,42,982,998,-16
88,1,43,763,882,-119
88,1,44,756,800,-44
88,1,45,761,855,-94
88,1,46,703,908,-205
88,1,47,706,882,-176
88,1,48,1170,741,429
88,1,49,730,904,-174
88,1,50,776,1031,-255
88,1,51,750,798,-48
88,1,52,766,972,-206
88,1,53,805,968,-163
88,1,55,737,962,-225
88,1,56,716,953,-237
88,1,57,684,903,-219
88,1,59,725,940,-215
88,1,60,769,792,-23
88,1,61,1274,875,399
88,1,62,790,813,-23
88,1,63,777,907,-130
88,1,64,894,775,119
88,1,65,837,797,40
88,1,66,791,838,-47
88,1,68,734,794,-60
88,1,70,922,817,105
88,1,71,627,774,-147
88,1,72,734,807,-73
89,3,1,863,988,-125
89,3,2,911,857,54
89,3,3,898,1129,-231
89,3,4,942,1156,-214
89,3,5,1033,1093,-60
89,3,6,1020,1067,-47
89,3,7,918,1025,-107
89,3,8,1047,1076,-29
89,3,9,1065,1087,-22
89,3,10,980,1124,-144
89,3,11,944,1100,-156
89,3,12,962,1079,-117
89,3,13,934,1077,-143
89,3,14,871,1021,-150
89,3,15,1104,1088,16
89,3,16,1094,1026,68
89,3,17,1073,1058,15
89,3,18,967,1243,-276
89,3,19,871,988,-117
89,3,20,822,1043,-221
89,3,21,888,1012,-124
89,3,22,886,988,-102
89,3,24,788,973,-185
89,3,25,1074,965,109
89,3,26,1438,1555,-117
89,3,27,1131,848,283
89,3,28,795,1204,-409
89,3,29,733,1243,-510
89,3,30,745,1267,-522
89,3,31,1040,787,253
89,3,32,706,787,-81
89,3,33,885,1118,-233
89,3,34,739,750,-11
89,3,35,1378,709,669
89,3,36,970,665,305
89,3,37,929,730,199
89,3,41,761,1210,-449
89,3,42,760,756,4
89,3,43,743,855,-112
89,3,44,1103,1603,-500
89,3,45,1060,1209,-149
89,3,46,722,719,3
89,3,48,1102,1027,75
89,3,49,751,664,87
89,3,50,1511,1547,-36
89,3,51,697,694,3
89,3,53,1135,809,326
89,3,54,945,761,184
89,3,55,931,767,164
89,3,57,1242,870,372
89,3,58,938,865,73
89,3,59,950,807,143
89,3,60,981,778,203
89,3,61,969,939,30
89,3,62,903,812,91
89,3,63,997,852,145
89,3,64,919,768,151
89,3,65,989,770,219
89,3,66,949,809,140
89,3,67,1079,826,253
89,3,68,935,833,102
89,3,70,1081,804,277
89,3,71,946,786,160
89,3,72,992,682,310
90,2,1,807,1116,-309
90,2,2,748,942,-194
90,2,3,813,859,-46
90,2,4,820,768,52
90,2,5,812,788,24
90,2,6,845,811,34
90,2,7,838,682,156
90,2,8,779,692,87
90,2,9,758,838,-80
90,2,10,764,770,-6
90,2,11,1077,767,310
90,2,12,806,775,31
90,2,13,1054,881,173
90,2,14,819,676,143
90,2,15,745,732,13
90,2,16,775,802,-27
90,2,17,753,743,10
90,2,18,795,746,49
90,2,19,700,662,38
90,2,21,644,668,-24
90,2,22,736,830,-94
90,2,23,824,778,46
90,2,24,806,598,208
90,2,25,755,672,83
90,2,26,765,719,46
90,2,27,785,725,60
90,2,28,695,743,-48
90,2,29,812,636,176
90,2,30,731,634,97
90,2,31,786,712,74
90,2,32,769,649,120
90,2,33,725,640,85
90,2,34,763,752,11
90,2,35,707,661,46
90,2,36,842,747,95
90,2,37,781,687,94
90,2,38,712,747,-35
90,2,39,722,679,43
90,2,40,797,757,40
90,2,41,977,716,261
90,2,42,669,677,-8
90,2,44,746,622,124
90,2,45,722,888,-166
90,2,46,697,627,70
90,2,48,734,912,-178
90,2,49,749,657,92
90,2,50,719,685,34
90,2,51,793,794,-1
90,2,52,732,807,-75
90,2,53,797,717,80
90,2,54,681,789,-108
90,2,56,804,818,-14
90,2,57,823,652,171
90,2,58,659,675,-16
90,2,59,675,675,0
90,2,60,750,674,76
90,2,61,713,715,-2
90,2,62,784,799,-15
90,2,63,758,720,38
90,2,64,760,637,123
90,2,65,741,692,49
90,2,66,736,622,114
90,2,67,723,847,-124
90,2,68,753,690,63
90,2,69,783,616,167
90,2,70,762,688,74
90,2,71,788,674,114
91,1,1,965,1308,-343
91,1,2,1003,928,75
91,1,3,935,905,30
91,1,4,796,1196,-400
91,1,5,1503,858,645
91,1,6,1037,755,282
91,1,7,947,1013,-66
91,1,8,576,754,-178
91,1,9,715,909,-194
91,1,10,828,768,60
91,1,11,948,781,167
91,1,12,815,853,-38
91,1,13,1039,703,336
91,1,14,877,488,389
91,1,15,575,699,-124
91,1,16,921,821,100
91,1,17,1056,797,259
91,1,18,880,761,119
91,1,19,749,667,82
91,1,20,809,695,114
91,1,21,745,641,104
91,1,22,767,804,-37
91,1,23,888,815,73
91,1,25,1169,657,512
91,1,26,825,742,83
91,1,27,849,842,7
91,1,28,802,834,-32
91,1,29,881,659,222
91,1,30,769,773,-4
91,1,31,1109,1161,-52
91,1,32,858,691,167
91,1,33,843,814,29
91,1,34,878,766,112
91,1,35,1378,733,645
91,1,36,847,686,161
91,1,37,1090,746,344
91,1,38,653,718,-65
91,1,39,748,851,-103
91,1,40,1071,873,198
91,1,41,688,747,-59
91,1,42,971,878,93
91,1,43,820,754,66
91,1,44,847,758,89
91,1,45,828,705,123
91,1,46,804,746,58
91,1,47,834,876,-42
91,1,48,883,775,108
91,1,49,676,911,-235
91,1,50,523,661,-138
91,1,51,741,832,-91
91,1,52,842,1024,-182
91,1,53,838,755,83
91,1,54,820,747,73
91,1,55,734,845,-111
91,1,56,741,755,-14
91,1,57,817,789,28
91,1,58,808,724,84
91,1,59,752,636,116
91,1,60,817,682,135
91,1,61,698,706,-8
91,1,62,828,681,147
91,1,63,752,632,120
91,1,64,754,366,388
91,1,65,654,724,-70
91,1,66,706,750,-44
91,1,67,794,867,-73
91,1,68,797,844,-47
91,1,69,744,1087,-343
91,1,70,828,742,86
91,1,71,654,638,16
91,1,72,629,866,-237
92,2,1,978,1352,-374
92,2,2,872,1236,-364
92,2,3,841,1195,-354
92,2,4,915,976,-61
92,2,5,898,1106,-208
92,2,6,879,1027,-148
92,2,7,883,1174,-291
92,2,8,915,998,-83
92,2,9,885,1096,-211
92,2,10,807,994,-187
92,2,11,1109,1245,-136
92,2,12,972,1058,-86
92,2,13,862,1468,-606
92,2,14,837,944,-107
92,2,15,902,1081,-179
92,2,16,975,998,-23
92,2,17,812,1116,-304
92,2,18,1189,999,190
92,2,19,845,1003,-158
92,2,20,854,1020,-166
92,2,21,814,1039,-225
92,2,22,921,1200,-279
92,2,23,1005,951,54
92,2,24,913,1069,-156
92,2,25,1022,1164,-142
92,2,26,1077,935,142
92,2,27,908,968,-60
92,2,28,854,917,-63
92,2,29,882,921,-39
92,2,30,851,950,-99
92,2,31,866,984,-118
92,2,32,945,976,-31
92,2,33,833,932,-99
92,2,34,863,998,-135
92,2,35,927,1056,-129
92,2,36,868,1071,-203
92,2,37,1523,820,703
92,2,38,811,1407,-596
92,2,39,817,994,-177
92,2,40,764,805,-41
92,2,41,880,970,-90
92,2,42,870,1037,-167
92,2,43,890,863,27
92,2,44,880,855,25
92,2,45,790,899,-109
92,2,46,864,896,-32
92,2,47,923,975,-52
92,2,48,863,957,-94
92,2,49,874,1133,-259
92,2,52,833,988,-155
92,2,53,1058,949,109
92,2,54,916,987,-71
92,2,55,907,1015,-108
92,2,56,1116,1116,0
92,2,57,847,981,-134
92,2,58,865,890,-25
92,2,59,791,886,-95
92,2,60,910,893,17
92,2,61,808,1041,-233
92,2,62,759,891,-132
92,2,63,1023,1069,-46
92,2,64,876,1004,-128
92,2,65,899,948,-49
92,2,66,968,870,98
92,2,67,901,953,-52
92,2,68,760,762,-2
92,2,69,963,1154,-191
92,2,71,837,1199,-362
92,2,72,820,970,-150
93,1,1,1016,959,57
93,1,3,779,775,4
93,1,4,736,796,-60
93,1,5,697,829,-132
93,1,6,800,579,221
93,1,7,768,748,20
93,1,8,1117,881,236
93,1,9,813,775,38
93,1,10,800,685,115
93,1,11,717,811,-94
93,1,13,781,877,-96
93,1,14,1069,561,508
93,1,15,760,806,-46
93,1,16,697,679,18
93,1,17,709,591,118
93,1,18,861,690,171
93,1,19,709,603,106
93,1,20,663,656,7
93,1,21,722,662,60
93,1,23,767,576,191
93,1,24,790,897,-107
93,1,26,723,770,-47
93,1,27,713,685,28
93,1,28,718,613,105
93,1,29,691,595,96
93,1,30,703,728,-25
93,1,31,806,699,107
93,1,32,745,708,37
93,1,33,740,706,34
93,1,34,694,648,46
93,1,36,668,688,-20
93,1,37,800,666,134
93,1,38,647,724,-77
93,1,39,806,661,145
93,1,40,697,646,51
93,1,41,1093,661,432
93,1,43,697,636,61
93,1,44,765,762,3
93,1,45,670,694,-24
93,1,46,755,680,75
93,1,47,900,747,153
93,1,48,802,732,70
93,1,49,713,689,24
93,1,50,822,705,117
93,1,51,795,679,116
93,1,52,749,685,64
93,1,53,780,744,36
93,1,55,693,666,27
93,1,56,711,714,-3
93,1,58,797,766,31
93,1,59,742,819,-77
93,1,61,1357,668,689
93,1,63,681,581,100
93,1,64,730,625,105
93,1,65,844,801,43
93,1,66,635,598,37
93,1,67,707,564,143
93,1,69,735,789,-54
93,1,70,736,626,110
93,1,71,701,622,79
93,1,72,740,873,-133
94,3,1,757,1070,-313
94,3,2,753,924,-171
94,3,3,851,745,106
94,3,4,830,853,-23
94,3,5,837,858,-21
94,3,6,836,780,56
94,3,7,802,739,63
94,3,8,800,693,107
94,3,9,835,824,11
94,3,10,936,846,90
94,3,11,899,737,162
94,3,12,902,742,160
94,3,13,839,718,121
94,3,14,760,646,114
94,3,15,877,686,191
94,3,16,850,736,114
94,3,17,748,669,79
94,3,18,852,642,210
94,3,19,889,794,95
94,3,20,794,696,98
94,3,21,787,658,129
94,3,22,834,663,171
94,3,23,831,840,-9
94,3,24,692,773,-81
94,3,25,791,855,-64
94,3,26,831,753,78
94,3,27,996,792,204
94,3,28,790,685,105
94,3,29,856,935,-79
94,3,30,840,720,120
94,3,31,786,678,108
94,3,32,819,739,80
94,3,33,834,906,-72
94,3,34,806,750,56
94,3,35,824,730,94
94,3,36,880,760,120
94,3,37,835,713,122
94,3,38,901,733,168
94,3,39,781,1411,-630
94,3,40,832,926,-94
94,3,41,907,705,202
94,3,42,795,748,47
94,3,43,800,626,174
94,3,44,827,784,43
94,3,45,757,875,-118
94,3,46,833,864,-31
94,3,47,871,688,183
94,3,48,821,692,129
94,3,49,731,758,-27
94,3,50,829,685,144
94,3,51,834,775,59
94,3,52,903,704,199
94,3,53,801,704,97
94,3,54,795,701,94
94,3,55,784,751,33
94,3,56,798,910,-112
94,3,57,828,1499,-671
94,3,58,758,773,-15
94,3,59,735,710,25
94,3,60,856,758,98
94,3,61,723,714,9
94,3,62,827,742,85
94,3,63,798,655,143
94,3,64,812,708,104
94,3,65,778,674,104
94,3,66,841,722,119
94,3,67,776,709,67
94,3,68,866,663,203
94,3,69,788,709,79
94,3,70,756,754,2
94,3,71,767,716,51
94,3,72,786,744,42
95,1,1,1124,1242,-118
95,1,2,844,1064,-220
95,1,3,959,948,11
95,1,4,949,1287,-338
95,1,5,846,1035,-189
95,1,6,921,1058,-137
95,1,7,867,1007,-140
95,1,8,998,910,88
95,1,9,826,1126,-300
95,1,10,949,906,43
95,1,12,915,987,-72
95,1,13,940,869,71
95,1,14,848,875,-27
95,1,15,884,932,-48
95,1,16,887,1131,-244
95,1,18,927,1000,-73
95,1,19,866,972,-106
95,1,20,1025,854,171
95,1,21,988,870,118
95,1,22,943,920,23
95,1,23,246,571,-325
95,1,27,947,943,4
95,1,29,800,713,87
95,1,30,864,453,411
95,1,32,723,823,-100
95,1,34,1090,1063,27
95,1,36,834,778,56
95,1,37,1133,1011,122
95,1,38,675,883,-208
95,1,39,879,828,51
95,1,40,953,818,135
95,1,41,985,742,243
95,1,43,1086,850,236
95,1,45,1177,893,284
95,1,46,1022,1045,-23
95,1,47,743,277,466
95,1,50,1002,791,211
95,1,52,824,1001,-177
95,1,53,870,700,170
95,1,54,968,899,69
95,1,55,853,763,90
95,1,56,815,1187,-372
95,1,58,912,888,24
95,1,60,737,881,-144
95,1,62,844,1075,-231
95,1,68,1227,1002,225
95,1,70,1065,1001,64
95,1,71,972,865,107
96,3,1,892,1040,-148
96,3,2,862,1106,-244
96,3,3,785,1199,-414
96,3,4,967,1082,-115
96,3,5,838,934,-96
96,3,6,920,913,7
96,3,7,1016,846,170
96,3,10,933,867,66
96,3,11,873,975,-102
96,3,13,928,948,-20
96,3,14,766,1018,-252
96,3,15,780,984,-204
96,3,16,867,1029,-162
96,3,17,842,990,-148
96,3,18,711,802,-91
96,3,19,797,810,-13
96,3,20,956,954,2
96,3,21,925,833,92
96,3,22,788,1182,-394
96,3,23,830,1091,-261
96,3,24,829,1005,-176
96,3,25,817,1032,-215
96,3,26,863,1110,-247
96,3,27,1587,1155,432
96,3,28,715,885,-170
96,3,29,739,782,-43
96,3,30,816,1074,-258
96,3,31,747,771,-24
96,3,32,825,907,-82
96,3,33,1032,796,236
96,3,34,836,790,46
96,3,35,768,864,-96
96,3,36,704,771,-67
96,3,37,747,713,34
96,3,38,804,1044,-240
96,3,39,768,868,-100
96,3,40,786,760,26
96,3,41,764,1075,-311
96,3,42,824,1273,-449
96,3,43,733,752,-19
96,3,44,799,1032,-233
96,3,45,796,960,-164
96,3,46,751,915,-164
96,3,47,781,884,-103
96,3,48,825,974,-149
96,3,49,736,1133,-397
96,3,50,741,857,-116
96,3,51,741,846,-105
96,3,52,772,939,-167
96,3,53,821,983,-162
96,3,54,788,917,-129
96,3,55,775,843,-68
96,3,56,782,972,-190
96,3,57,788,1017,-229
96,3,58,735,962,-227
96,3,59,749,892,-143
96,3,60,797,1045,-248
96,3,61,773,957,-184
96,3,62,756,929,-173
96,3,63,790,979,-189
96,3,64,1021,963,58
96,3,65,784,874,-90
96,3,66,933,1346,-413
96,3,67,887,856,31
96,3,68,741,902,-161
96,3,69,915,1106,-191
96,3,70,878,960,-82
96,3,71,829,874,-45
96,3,72,1807,1144,663
97,2,1,881,1152,-271
97,2,2,879,1008,-129
97,2,3,812,740,72
97,2,4,881,873,8
97,2,5,855,647,208
97,2,6,897,690,207
97,2,7,830,705,125
97,2,8,788,680,108
97,2,9,783,667,116
97,2,10,993,803,190
97,2,11,866,810,56
97,2,12,782,629,153
97,2,13,879,728,151
97,2,14,877,741,136
97,2,15,814,810,4
97,2,16,831,646,185
97,2,17,721,682,39
97,2,18,797,716,81
97,2,19,859,733,126
97,2,20,888,909,-21
97,2,21,714,671,43
97,2,22,850,692,158
97,2,23,900,696,204
97,2,24,854,721,133
97,2,25,807,1137,-330
97,2,26,844,612,232
97,2,27,765,694,71
97,2,28,848,672,176
97,2,30,839,656,183
97,2,31,762,675,87
97,2,32,796,624,172
97,2,33,808,634,174
97,2,34,912,550,362
97,2,35,774,569,205
97,2,36,798,661,137
97,2,37,887,654,233
97,2,38,800,681,119
97,2,39,794,636,158
97,2,40,862,694,168
97,2,41,825,666,159
97,2,42,901,722,179
97,2,43,1011,885,126
97,2,45,1455,771,684
97,2,46,799,787,12
97,2,47,829,607,222
97,2,48,857,782,75
97,2,49,738,680,58
97,2,50,765,630,135
97,2,51,702,509,193
97,2,52,670,773,-103
97,2,53,770,1166,-396
97,2,54,755,788,-33
97,2,55,772,670,102
97,2,56,819,706,113
97,2,57,843,592,251
97,2,58,754,797,-43
97,2,59,734,721,13
97,2,60,932,637,295
97,2,61,856,681,175
97,2,62,729,704,25
97,2,63,809,688,121
97,2,64,818,633,185
97,2,65,714,712,2
97,2,66,719,986,-267
97,2,67,820,687,133
97,2,68,809,627,182
97,2,69,748,638,110
97,2,70,916,581,335
97,2,71,816,666,150
97,2,72,794,873,-79
98,2,1,917,1324,-407
98,2,3,945,1036,-91
98,2,4,997,957,40
98,2,5,1030,747,283
98,2,6,1022,649,373
98,2,7,919,761,158
98,2,8,996,740,256
98,2,9,1088,680,408
98,2,10,966,545,421
98,2,11,1062,671,391
98,2,12,941,518,423
98,2,13,998,643,355
98,2,14,908,549,359
98,2,15,1075,572,503
98,2,16,1302,372,930
98,2,17,1331,422,909
98,2,18,980,238,742
98,2,19,891,780,111
98,2,20,947,564,383
98,2,21,824,368,456
98,2,22,1052,67,985
98,2,23,889,314,575
98,2,24,888,346,542
98,2,25,939,357,582
98,2,26,1012,275,737
98,2,27,1263,366,897
98,2,28,1497,209,1288
98,2,29,1050,155,895
98,2,30,971,281,690
98,2,31,853,279,574
98,2,32,870,896,-26
98,2,33,960,309,651
98,2,34,928,390,538
98,2,36,1072,223,849
98,2,37,902,231,671
98,2,38,921,235,686
98,2,39,1172,177,995
98,2,40,838,336,502
98,2,41,968,1016,-48
98,2,42,1020,296,724
98,2,43,933,278,655
98,2,44,854,222,632
98,2,45,928,88,840
98,2,47,945,913,32
98,2,48,922,89,833
98,2,49,741,52,689
98,2,50,672,322,350
98,2,51,860,724,136
98,2,52,942,63,879
98,2,53,869,61,808
98,2,54,1014,135,879
98,2,56,516,304,212
98,2,58,829,246,583
98,2,59,845,312,533
98,2,60,872,392,480
98,2,61,543,598,-55
98,2,63,919,287,632
98,2,64,787,214,573
98,2,65,493,106,387
98,2,66,821,180,641
98,2,67,794,100,694
98,2,68,736,217,519
98,2,69,948,735,213
98,2,70,901,180,721
98,2,71,949,326,623
98,2,72,799,277,522
99,1,1,1027,1250,-223
99,1,2,1075,1044,31
99,1,3,952,1081,-129
99,1,4,983,955,28
99,1,5,1067,919,148
99,1,6,891,999,-108
99,1,7,1090,928,162
99,1,8,900,630,270
99,1,9,1369,1217,152
99,1,10,948,883,65
99,1,11,1005,573,432
99,1,12,863,1018,-155
99,1,13,979,657,322
99,1,14,899,430,469
99,1,15,1171,491,680
99,1,16,878,379,499
99,1,17,884,397,487
99,1,18,698,513,185
99,1,19,1073,311,762
99,1,20,915,479,436
99,1,21,879,420,459
99,1,22,981,641,340
99,1,23,985,545,440
99,1,24,925,398,527
99,1,25,556,259,297
99,1,26,583,249,334
99,1,27,1134,864,270
99,1,28,616,487,129
99,1,29,887,487,400
99,1,30,851,296,555
99,1,31,860,443,417
99,1,32,831,475,356
99,1,33,790,512,278
99,1,34,833,527,306
99,1,35,637,389,248
99,1,36,875,535,340
99,1,37,820,488,332
99,1,38,761,400,361
99,1,39,822,431,391
99,1,40,812,601,211
99,1,41,809,347,462
99,1,42,739,249,490
99,1,43,694,264,430
99,1,44,899,140,759
99,1,45,865,140,725
99,1,46,603,229,374
99,1,47,506,68,438
99,1,48,752,461,291
99,1,49,885,379,506
99,1,50,852,305,547
99,1,51,906,447,459
99,1,52,589,516,73
99,1,53,832,289,543
99,1,54,768,351,417
99,1,55,841,395,446
99,1,56,716,310,406
99,1,57,779,418,361
99,1,58,773,312,461
99,1,59,603,376,227
99,1,60,737,274,463
99,1,61,742,409,333
99,1,62,928,288,640
99,1,63,759,491,268
99,1,64,665,599,66
99,1,65,622,362,260
99,1,66,799,444,355
99,1,67,768,398,370
99,1,68,782,342,440
99,1,69,765,420,345
99,1,70,611,355,256
99,1,71,776,410,366
99,1,72,1041,621,420
100,2,1,912,1125,-213
100,2,2,800,983,-183
100,2,3,849,777,72
100,2,4,851,856,-5
100,2,5,809,1051,-242
100,2,6,900,800,100
100,2,7,760,880,-120
100,2,8,820,649,171
100,2,9,936,743,193
100,2,10,845,693,152
100,2,11,844,752,92
100,2,12,708,733,-25
100,2,13,920,637,283
100,2,14,692,645,47
100,2,15,898,800,98
100,2,16,853,679,174
100,2,17,842,763,79
100,2,18,955,731,224
100,2,19,761,630,131
100,2,21,761,734,27
100,2,22,918,761,157
100,2,23,735,869,-134
100,2,24,803,844,-41
100,2,25,755,758,-3
100,2,26,789,873,-84
100,2,27,757,835,-78
100,2,28,819,593,226
100,2,29,945,845,100
100,2,30,778,718,60
100,2,31,775,673,102
100,2,33,744,651,93
100,2,34,794,750,44
100,2,35,1040,648,392
100,2,36,702,610,92
100,2,37,735,872,-137
100,2,38,776,631,145
100,2,39,705,682,23
100,2,40,711,664,47
100,2,41,751,918,-167
100,2,43,735,631,104
100,2,44,824,649,175
100,2,46,736,641,95
100,2,49,1108,816,292
100,2,50,694,649,45
100,2,52,739,627,112
100,2,53,661,412,249
100,2,56,675,810,-135
100,2,57,975,1036,-61
100,2,59,714,709,5
100,2,60,807,291,516
100,2,62,790,422,368
100,2,64,705,481,224
100,2,66,649,423,226
100,2,67,723,445,278
100,2,68,645,407,238
100,2,69,711,313,398
100,2,70,718,351,367
100,2,71,709,279,430
100,2,72,779,459,320
101,1,3,904,1210,-306
101,1,4,897,1147,-250
101,1,5,935,1052,-117
101,1,7,835,1385,-550
101,1,8,1005,905,100
101,1,9,991,1091,-100
101,1,10,903,931,-28
101,1,11,1060,1432,-372
101,1,12,810,942,-132
101,1,13,855,823,32
101,1,14,790,784,6
101,1,15,788,903,-115
101,1,17,814,1061,-247
101,1,18,781,832,-51
101,1,19,1060,974,86
101,1,20,1845,966,879
101,1,21,1537,974,563
101,1,22,1108,1202,-94
101,1,23,1019,846,173
101,1,24,1055,1017,38
101,1,58,1013,1023,-10
101,1,61,1758,1125,633
102,3,1,764,1170,-406
102,3,2,772,922,-150
102,3,3,813,823,-10
102,3,4,871,760,111
102,3,5,815,743,72
102,3,6,827,775,52
102,3,7,804,962,-158
102,3,8,767,785,-18
102,3,9,803,690,113
102,3,11,1046,651,395
102,3,12,733,723,10
102,3,14,807,924,-117
102,3,15,827,759,68
102,3,16,742,846,-104
102,3,17,701,625,76
102,3,18,738,695,43
102,3,19,830,743,87
102,3,20,794,772,22
102,3,22,770,798,-28
102,3,23,826,701,125
102,3,24,767,750,17
102,3,25,773,713,60
102,3,26,733,696,37
102,3,31,717,835,-118
102,3,32,768,657,111
102,3,33,783,741,42
102,3,34,955,736,219
102,3,35,761,774,-13
102,3,36,765,827,-62
102,3,44,813,791,22
102,3,45,750,772,-22
102,3,46,732,665,67
102,3,47,767,755,12
102,3,48,916,587,329
102,3,49,797,584,213
102,3,50,717,705,12
102,3,51,1138,1440,-302
102,3,55,1032,864,168
102,3,56,700,635,65
102,3,57,827,850,-23
102,3,58,701,717,-16
102,3,59,844,799,45
102,3,60,706,688,18
102,3,72,815,915,-100
103,3,1,1190,1260,-70
103,3,2,971,1187,-216
103,3,3,955,1545,-590
103,3,4,1076,1080,-4
103,3,5,887,1040,-153
103,3,6,953,1116,-163
103,3,7,1010,1138,-128
103,3,8,1066,1208,-142
103,3,9,1076,1122,-46
103,3,10,861,1327,-466
103,3,11,962,1272,-310
103,3,12,870,1078,-208
103,3,13,861,1168,-307
103,3,14,876,851,25
103,3,15,878,890,-12
103,3,16,875,1119,-244
103,3,17,858,1144,-286
103,3,18,920,1069,-149
103,3,19,908,1136,-228
103,3,20,837,1176,-339
103,3,21,897,1231,-334
103,3,22,988,1262,-274
103,3,23,1000,1243,-243
103,3,24,907,1086,-179
103,3,25,1181,965,216
103,3,26,827,987,-160
103,3,27,824,939,-115
103,3,28,863,988,-125
103,3,29,843,1002,-159
103,3,30,829,845,-16
103,3,31,780,743,37
103,3,32,879,815,64
103,3,33,875,1173,-298
103,3,34,1129,781,348
103,3,35,919,1161,-242
103,3,36,778,845,-67
103,3,37,830,939,-109
103,3,38,814,896,-82
103,3,39,849,1027,-178
103,3,40,854,1279,-425
103,3,41,815,810,5
103,3,42,900,932,-32
103,3,43,911,871,40
103,3,44,773,891,-118
103,3,45,1048,798,250
103,3,47,832,792,40
103,3,48,859,914,-55
103,3,49,897,954,-57
103,3,50,894,1176,-282
103,3,51,832,1313,-481
103,3,52,834,910,-76
103,3,53,822,998,-176
103,3,54,854,871,-17
103,3,55,808,954,-146
103,3,56,858,1556,-698
103,3,57,901,996,-95
103,3,58,818,878,-60
103,3,59,799,1193,-394
103,3,60,886,984,-98
103,3,61,999,793,206
103,3,62,887,1027,-140
103,3,63,1626,851,775
103,3,64,791,979,-188
103,3,65,818,1077,-259
103,3,66,1394,1048,346
103,3,67,833,1333,-500
103,3,68,809,1018,-209
103,3,69,738,1006,-268
103,3,70,940,1032,-92
103,3,71,1218,1510,-292
104,2,2,753,997,-244
104,2,3,838,857,-19
104,2,4,803,960,-157
104,2,5,753,846,-93
104,2,6,868,868,0
104,2,7,890,913,-23
104,2,8,755,730,25
104,2,9,755,836,-81
104,2,10,797,743,54
104,2,11,843,813,30
104,2,12,791,820,-29
104,2,13,750,702,48
104,2,14,757,862,-105
104,2,15,790,785,5
104,2,16,738,775,-37
104,2,17,733,717,16
104,2,18,843,709,134
104,2,19,733,742,-9
104,2,20,791,738,53
104,2,21,705,1040,-335
104,2,22,803,749,54
104,2,23,945,711,234
104,2,24,790,713,77
104,2,25,788,821,-33
104,2,26,742,703,39
104,2,27,821,843,-22
104,2,28,704,751,-47
104,2,29,789,705,84
104,2,30,743,720,23
104,2,31,786,824,-38
104,2,32,818,718,100
104,2,33,670,786,-116
104,2,34,772,728,44
104,2,35,830,870,-40
104,2,36,675,751,-76
104,2,37,691,853,-162
104,2,38,736,657,79
104,2,39,734,856,-122
104,2,40,749,1028,-279
104,2,41,693,927,-234
104,2,42,717,792,-75
104,2,43,797,831,-34
104,2,44,708,718,-10
104,2,45,751,651,100
104,2,46,924,861,63
104,2,47,776,893,-117
104,2,48,835,804,31
104,2,49,751,711,40
104,2,50,735,740,-5
104,2,51,754,702,52
104,2,52,778,721,57
104,2,53,752,738,14
104,2,54,785,789,-4
104,2,55,750,677,73
104,2,56,931,1252,-321
104,2,57,786,870,-84
104,2,58,891,952,-61
104,2,59,766,766,0
104,2,60,789,859,-70
104,2,61,715,876,-161
104,2,62,741,896,-155
104,2,63,673,700,-27
104,2,64,759,631,128
104,2,65,852,706,146
104,2,66,687,696,-9
104,2,67,898,828,70
104,2,68,985,846,139
104,2,69,951,898,53
104,2,70,769,726,43
104,2,71,656,641,15
104,2,72,693,585,108
105,2,1,895,1167,-272
105,2,2,923,999,-76
105,2,3,983,1019,-36
105,2,4,838,807,31
105,2,5,824,815,9
105,2,6,895,834,61
105,2,7,941,808,133
105,2,8,891,703,188
105,2,9,863,833,30
105,2,10,717,723,-6
105,2,11,987,646,341
105,2,12,866,697,169
105,2,13,797,881,-84
105,2,14,771,680,91
105,2,15,864,732,132
105,2,16,782,857,-75
105,2,17,851,702,149
105,2,18,870,715,155
105,2,19,1014,800,214
105,2,21,796,778,18
105,2,22,803,794,9
105,2,23,837,774,63
105,2,24,810,770,40
105,2,25,740,774,-34
105,2,26,809,685,124
105,2,27,792,777,15
105,2,28,765,796,-31
105,2,29,764,735,29
105,2,30,740,954,-214
105,2,31,1016,676,340
105,2,32,827,844,-17
105,2,33,785,655,130
105,2,34,846,715,131
105,2,35,1106,770,336
105,2,36,733,707,26
105,2,37,757,748,9
105,2,38,795,690,105
105,2,39,713,1330,-617
105,2,40,1154,893,261
105,2,41,812,685,127
105,2,42,741,973,-232
105,2,43,902,1566,-664
105,2,44,785,736,49
105,2,45,732,690,42
105,2,46,763,717,46
105,2,47,818,726,92
105,2,48,724,677,47
105,2,49,794,798,-4
105,2,50,812,953,-141
105,2,51,959,922,37
105,2,52,895,736,159
105,2,53,752,805,-53
105,2,54,1134,986,148
105,2,55,849,717,132
105,2,56,791,661,130
105,2,57,717,662,55
105,2,58,760,660,100
105,2,59,779,768,11
105,2,60,856,781,75
105,2,61,1436,674,762
105,2,62,678,617,61
105,2,63,766,776,-10
105,2,64,690,739,-49
105,2,65,911,717,194
105,2,66,815,711,104
105,2,67,766,836,-70
105,2,68,805,761,44
105,2,70,798,740,58
105,2,71,837,678,159
105,2,72,725,637,88
106,3,1,1020,1085,-65
106,3,2,1001,1066,-65
106,3,3,923,1109,-186
106,3,4,1021,1103,-82
106,3,5,937,1103,-166
106,3,6,1010,954,56
106,3,7,996,951,45
106,3,8,919,827,92
106,3,9,986,893,93
106,3,10,905,1111,-206
106,3,11,935,858,77
106,3,12,939,1097,-158
106,3,13,873,958,-85
106,3,14,921,970,-49
106,3,16,823,834,-11
106,3,17,891,928,-37
106,3,18,943,1075,-132
106,3,19,870,731,139
106,3,20,858,872,-14
106,3,21,823,725,98
106,3,22,857,815,42
106,3,23,797,755,42
106,3,24,887,698,189
106,3,26,871,859,12
106,3,27,906,792,114
106,3,28,825,727,98
106,3,29,857,906,-49
106,3,30,919,1019,-100
106,3,31,1020,840,180
106,3,32,912,806,106
106,3,33,884,745,139
106,3,34,840,804,36
106,3,35,856,807,49
106,3,36,938,907,31
106,3,37,891,809,82
106,3,38,954,863,91
106,3,39,821,888,-67
106,3,40,883,705,178
106,3,41,869,828,41
106,3,42,857,808,49
106,3,43,923,815,108
106,3,44,760,771,-11
106,3,45,906,737,169
106,3,46,1007,919,88
106,3,48,920,870,50
106,3,49,906,837,69
106,3,50,822,778,44
106,3,51,837,841,-4
106,3,52,873,742,131
106,3,53,800,747,53
106,3,54,794,772,22
106,3,55,805,723,82
106,3,56,921,710,211
106,3,57,859,826,33
106,3,58,826,880,-54
106,3,59,909,823,86
106,3,60,924,833,91
106,3,61,839,837,2
106,3,62,885,781,104
106,3,63,857,778,79
106,3,64,741,700,41
106,3,65,764,838,-74
106,3,66,768,774,-6
106,3,67,822,1076,-254
106,3,68,824,689,135
106,3,69,792,712,80
106,3,70,862,711,151
106,3,71,822,792,30
106,3,72,788,843,-55
107,1,1,1401,985,416
107,1,2,941,847,94
107,1,3,945,822,123
107,1,4,1179,1147,32
107,1,5,1172,972,200
107,1,6,1052,958,94
107,1,7,1307,910,397
107,1,8,1023,752,271
107,1,9,1094,1023,71
107,1,10,864,761,103
107,1,11,805,725,80
107,1,12,1089,730,359
107,1,13,767,649,118
107,1,14,873,787,86
107,1,15,935,739,196
107,1,16,988,711,277
107,1,17,866,899,-33
107,1,18,887,968,-81
107,1,19,1765,1542,223
107,1,20,854,1064,-210
107,1,21,842,678,164
107,1,22,862,968,-106
107,1,24,892,815,77
107,1,25,1418,1034,384
107,1,26,978,1003,-25
107,1,27,1025,1017,8
107,1,28,901,1295,-394
107,1,29,998,1009,-11
107,1,30,981,966,15
107,1,31,991,1050,-59
107,1,32,919,1306,-387
107,1,33,1007,1107,-100
107,1,34,1036,1093,-57
107,1,35,860,1046,-186
107,1,36,919,1177,-258
107,1,37,863,792,71
107,1,38,893,897,-4
107,1,39,845,728,117
107,1,40,873,797,76
107,1,41,833,728,105
107,1,42,1529,978,551
107,1,43,877,748,129
107,1,44,882,603,279
107,1,45,1184,698,486
107,1,46,816,1051,-235
107,1,47,857,682,175
107,1,48,771,630,141
107,1,49,875,806,69
107,1,50,899,612,287
107,1,51,864,659,205
107,1,52,817,795,22
107,1,53,936,848,88
107,1,54,934,1237,-303
107,1,55,867,701,166
107,1,56,946,772,174
107,1,57,963,783,180
107,1,58,886,752,134
107,1,59,899,833,66
107,1,60,807,841,-34
107,1,61,1597,1293,304
107,1,62,892,684,208
107,1,63,873,899,-26
107,1,64,829,751,78
107,1,65,884,635,249
107,1,66,787,985,-198
107,1,67,815,720,95
107,1,70,874,804,70
107,1,72,1169,683,486
108,3,1,941,1304,-363
108,3,2,888,1202,-314
108,3,3,828,1151,-323
108,3,4,794,859,-65
108,3,5,804,1110,-306
108,3,6,1114,1142,-28
108,3,7,829,1443,-614
108,3,8,852,957,-105
108,3,9,874,971,-97
108,3,10,770,915,-145
108,3,11,743,891,-148
108,3,12,706,800,-94
108,3,13,1135,811,324
108,3,14,1017,963,54
108,3,15,768,1006,-238
108,3,16,748,837,-89
108,3,17,745,874,-129
108,3,18,720,807,-87
108,3,20,820,773,47
108,3,21,894,836,58
108,3,22,725,808,-83
108,3,23,667,834,-167
108,3,24,725,903,-178
108,3,25,771,712,59
108,3,26,857,1148,-291
108,3,27,1251,1050,201
108,3,28,753,768,-15
108,3,29,829,719,110
108,3,30,776,841,-65
108,3,31,769,766,3
108,3,32,763,804,-41
108,3,33,721,856,-135
108,3,34,783,744,39
108,3,35,778,745,33
108,3,36,996,1053,-57
108,3,37,775,1008,-233
108,3,38,1408,854,554
108,3,39,812,997,-185
108,3,40,781,849,-68
108,3,41,823,855,-32
108,3,42,794,921,-127
108,3,43,753,699,54
108,3,44,844,733,111
108,3,45,825,906,-81
108,3,46,1019,957,62
108,3,47,727,841,-114
108,3,48,678,711,-33
108,3,50,953,1048,-95
108,3,51,1225,1309,-84
108,3,52,1013,1225,-212
108,3,53,989,1048,-59
108,3,54,1098,996,102
108,3,55,1074,1169,-95
108,3,56,956,1030,-74
108,3,57,825,867,-42
108,3,58,961,1020,-59
108,3,59,936,1075,-139
108,3,60,900,887,13
108,3,61,873,833,40
108,3,62,1036,1217,-181
108,3,63,1046,1026,20
108,3,64,1154,1097,57
108,3,65,1542,913,629
108,3,66,870,816,54
108,3,67,918,919,-1
108,3,68,986,907,79
108,3,69,1140,953,187
108,3,70,901,857,44
108,3,71,838,946,-108
108,3,72,1124,896,228
109,3,1,967,1480,-513
109,3,2,1064,1448,-384
109,3,3,1043,1226,-183
109,3,4,879,1176,-297
109,3,5,1233,969,264
109,3,6,1027,1144,-117
109,3,7,878,820,58
109,3,8,892,1164,-272
109,3,9,1052,1059,-7
109,3,10,1138,1301,-163
109,3,11,926,1268,-342
109,3,12,942,986,-44
109,3,13,953,1095,-142
109,3,14,868,788,80
109,3,15,1159,1023,136
109,3,16,857,1027,-170
109,3,17,800,870,-70
109,3,18,943,811,132
109,3,19,908,1239,-331
109,3,20,1071,1362,-291
109,3,22,789,1584,-795
109,3,23,941,831,110
109,3,24,970,888,82
109,3,25,978,1002,-24
109,3,26,1027,857,170
109,3,28,1033,1200,-167
109,3,29,1015,928,87
109,3,30,874,1138,-264
109,3,31,957,1020,-63
109,3,32,978,892,86
109,3,33,851,890,-39
109,3,34,911,1532,-621
109,3,36,945,912,33
109,3,37,967,970,-3
109,3,38,918,747,171
109,3,39,954,1062,-108
109,3,40,1067,1052,15
109,3,41,960,837,123
109,3,42,1367,996,371
109,3,43,984,1029,-45
109,3,44,935,812,123
109,3,45,944,969,-25
109,3,46,739,1247,-508
109,3,47,853,1060,-207
109,3,49,860,1051,-191
109,3,50,846,780,66
109,3,51,894,994,-100
109,3,52,1213,895,318
109,3,53,1089,950,139
109,3,54,888,990,-102
109,3,55,938,1165,-227
109,3,56,924,999,-75
109,3,57,1092,1656,-564
109,3,58,1129,979,150
109,3,59,962,1103,-141
109,3,60,1051,978,73
109,3,61,941,1082,-141
109,3,62,858,1070,-212
109,3,63,839,984,-145
109,3,64,911,1006,-95
109,3,65,966,1221,-255
109,3,66,965,1106,-141
109,3,67,1083,1136,-53
109,3,68,815,947,-132
109,3,69,946,1053,-107
109,3,70,1110,1021,89
109,3,71,994,1111,-117
109,3,72,1011,1134,-123
110,1,2,1066,1296,-230
110,1,3,983,1181,-198
110,1,4,1079,1104,-25
110,1,5,1006,1191,-185
110,1,6,937,1052,-115
110,1,7,970,1003,-33
110,1,8,980,1096,-116
110,1,9,952,1077,-125
110,1,10,968,1479,-511
110,1,11,967,1089,-122
110,1,12,960,995,-35
110,1,13,908,983,-75
110,1,14,876,1026,-150
110,1,15,894,930,-36
110,1,16,985,1058,-73
110,1,17,863,924,-61
110,1,18,984,1023,-39
110,1,19,877,928,-51
110,1,20,1017,1158,-141
110,1,21,874,1041,-167
110,1,22,917,907,10
110,1,23,1060,951,109
110,1,24,932,842,90
110,1,25,814,1006,-192
110,1,27,934,891,43
110,1,28,867,1116,-249
110,1,29,942,896,46
110,1,30,919,957,-38
110,1,31,1098,932,166
110,1,32,1015,840,175
110,1,33,927,933,-6
110,1,34,940,958,-18
110,1,35,954,926,28
110,1,36,891,881,10
110,1,37,1148,848,300
110,1,38,948,1202,-254
110,1,39,917,1068,-151
110,1,40,900,1050,-150
110,1,41,909,915,-6
110,1,42,1028,868,160
110,1,43,953,1089,-136
110,1,44,891,1003,-112
110,1,45,965,970,-5
110,1,46,1058,1174,-116
110,1,47,970,908,62
110,1,48,899,930,-31
110,1,49,837,1115,-278
110,1,50,848,867,-19
110,1,51,897,1014,-117
110,1,52,899,1040,-141
110,1,53,1054,1006,48
110,1,54,1000,952,48
110,1,55,920,816,104
110,1,56,931,1025,-94
110,1,57,932,987,-55
110,1,58,882,1084,-202
110,1,59,850,1066,-216
110,1,60,886,954,-68
110,1,61,920,845,75
110,1,62,888,820,68
110,1,63,862,888,-26
110,1,64,866,819,47
110,1,65,851,874,-23
110,1,66,898,910,-12
110,1,67,873,924,-51
110,1,68,799,840,-41
110,1,69,951,984,-33
110,1,70,983,945,38
110,1,71,878,884,-6
110,1,72,911,950,-39
111,2,1,910,1043,-133
111,2,2,832,906,-74
111,2,3,1003,711,292
111,2,4,754,654,100
111,2,5,806,835,-29
111,2,6,801,695,106
111,2,7,823,884,-61
111,2,8,749,698,51
111,2,9,743,619,124
111,2,10,770,750,20
111,2,11,771,673,98
111,2,12,756,810,-54
111,2,14,907,646,261
111,2,15,747,663,84
111,2,16,724,1144,-420
111,2,17,752,668,84
111,2,18,646,681,-35
111,2,19,751,693,58
111,2,20,731,655,76
111,2,21,686,739,-53
111,2,22,773,779,-6
111,2,23,762,686,76
111,2,24,618,654,-36
111,2,25,712,691,21
111,2,26,660,649,11
111,2,27,737,670,67
111,2,28,697,613,84
111,2,29,823,803,20
111,2,30,770,719,51
111,2,31,732,737,-5
111,2,32,728,676,52
111,2,33,688,685,3
111,2,34,788,753,35
111,2,35,610,718,-108
111,2,36,780,745,35
111,2,37,736,685,51
111,2,38,746,621,125
111,2,39,706,791,-85
111,2,40,833,669,164
111,2,41,762,646,116
111,2,42,656,653,3
111,2,43,679,699,-20
111,2,44,1077,610,467
111,2,45,750,572,178
111,2,46,689,646,43
111,2,47,627,648,-21
111,2,48,706,775,-69
111,2,49,688,645,43
111,2,50,709,731,-22
111,2,51,641,717,-76
111,2,52,827,782,45
111,2,53,711,660,51
111,2,54,676,680,-4
111,2,55,676,681,-5
111,2,56,716,617,99
111,2,57,708,672,36
111,2,58,744,564,180
111,2,59,686,812,-126
111,2,60,726,787,-61
111,2,61,658,543,115
111,2,62,571,584,-13
111,2,63,700,657,43
111,2,64,687,732,-45
111,2,66,733,682,51
111,2,67,667,663,4
111,2,68,773,714,59
111,2,69,771,655,116
111,2,70,802,792,10
111,2,71,757,713,44
111,2,72,879,700,179
112,2,1,889,1136,-247
112,2,2,782,915,-133
112,2,3,836,865,-29
112,2,4,738,802,-64
112,2,5,752,887,-135
112,2,6,756,751,5
112,2,7,823,844,-21
112,2,8,893,806,87
112,2,9,747,1136,-389
112,2,10,843,822,21
112,2,11,785,1006,-221
112,2,12,700,758,-58
112,2,13,825,700,125
112,2,14,689,861,-172
112,2,15,813,853,-40
112,2,16,657,740,-83
112,2,17,748,682,66
112,2,18,773,730,43
112,2,19,770,778,-8
112,2,20,702,837,-135
112,2,21,715,798,-83
112,2,22,735,685,50
112,2,23,769,702,67
112,2,24,666,774,-108
112,2,25,700,719,-19
112,2,26,707,840,-133
112,2,27,707,929,-222
112,2,28,735,640,95
112,2,29,749,594,155
112,2,30,771,683,88
112,2,32,673,729,-56
112,2,33,696,671,25
112,2,34,755,671,84
112,2,35,822,722,100
112,2,36,744,648,96
112,2,37,809,670,139
112,2,40,798,707,91
112,2,41,806,788,18
112,2,42,779,688,91
112,2,43,611,615,-4
112,2,44,728,661,67
112,2,45,779,601,178
112,2,46,743,669,74
112,2,47,947,672,275
112,2,48,812,724,88
112,2,49,755,649,106
112,2,50,589,659,-70
112,2,51,757,609,148
112,2,52,807,720,87
112,2,53,687,778,-91
112,2,54,753,667,86
112,2,55,739,589,150
112,2,58,740,663,77
112,2,60,794,887,-93
112,2,61,702,409,293
112,2,62,747,542,205
112,2,63,765,502,263
112,2,64,707,482,225
112,2,65,720,495,225
112,2,66,644,472,172
112,2,67,743,443,300
112,2,68,844,670,174
112,2,69,814,779,35
112,2,70,789,463,326
112,2,71,695,755,-60
112,2,72,758,673,85
113,3,2,1529,935,594
113,3,3,1283,1071,212
113,3,4,998,937,61
113,3,5,1137,947,190
113,3,6,1198,1099,99
113,3,7,1260,1047,213
113,3,8,1372,993,379
113,3,9,1349,1013,336
113,3,10,1443,1312,131
113,3,11,1112,1151,-39
113,3,12,1419,1206,213
113,3,13,1040,1094,-54
113,3,14,1487,976,511
113,3,15,1492,1135,357
113,3,16,1619,999,620
113,3,17,1253,1157,96
113,3,18,1071,1086,-15
113,3,19,1096,1038,58
113,3,20,1133,1117,16
113,3,21,959,1761,-802
113,3,23,1134,1136,-2
113,3,24,1449,1240,209
113,3,25,1212,909,303
113,3,26,1544,1374,170
113,3,27,1102,1223,-121
113,3,28,1159,1300,-141
113,3,29,1283,1173,110
113,3,30,1043,1230,-187
113,3,33,1306,1088,218
113,3,34,1146,1033,113
113,3,35,1661,1079,582
113,3,36,1111,1087,24
113,3,37,1141,1032,109
113,3,38,1133,994,139
113,3,39,1482,1086,396
113,3,41,1022,1184,-162
113,3,42,1093,1004,89
113,3,43,1289,1114,175
113,3,44,1140,1131,9
113,3,45,1248,1058,190
113,3,46,1748,1369,379
113,3,47,922,1019,-97
113,3,48,949,996,-47
113,3,49,1106,943,163
113,3,50,1160,1335,-175
113,3,51,1053,1283,-230
113,3,53,990,1051,-61
113,3,54,1017,1085,-68
113,3,56,898,882,16
113,3,57,1034,998,36
113,3,58,1048,904,144
113,3,59,1115,935,180
113,3,60,1091,1076,15
113,3,62,919,876,43
113,3,63,1062,923,139
113,3,64,946,1072,-126
113,3,65,1273,932,341
113,3,66,970,1061,-91
113,3,67,1213,1111,102
113,3,69,1233,1088,145
113,3,70,982,1091,-109
113,3,71,1174,1157,17
113,3,72,1083,1124,-41
114,3,1,1081,951,130
114,3,2,987,1056,-69
114,3,3,823,914,-91
114,3,4,1013,1163,-150
114,3,5,927,884,43
114,3,6,954,802,152
114,3,7,1666,798,868
114,3,8,918,686,232
114,3,10,784,684,100
114,3,11,787,699,88
114,3,12,710,680,30
114,3,13,853,738,115
114,3,15,812,645,167
114,3,16,702,689,13
114,3,17,737,901,-164
114,3,18,927,735,192
114,3,19,781,768,13
114,3,20,780,813,-33
114,3,21,738,659,79
114,3,22,854,698,156
114,3,23,763,793,-30
114,3,24,823,881,-58
114,3,25,810,804,6
114,3,26,797,710,87
114,3,27,791,679,112
114,3,28,819,609,210
114,3,29,710,811,-101
114,3,30,921,702,219
114,3,31,804,699,105
114,3,33,659,727,-68
114,3,34,759,670,89
114,3,35,823,672,151
114,3,36,739,695,44
114,3,37,808,971,-163
114,3,38,908,650,258
114,3,39,905,689,216
114,3,40,787,696,91
114,3,41,793,755,38
114,3,42,740,771,-31
114,3,43,745,708,37
114,3,44,776,713,63
114,3,45,936,639,297
114,3,46,863,700,163
114,3,47,865,736,129
114,3,48,700,733,-33
114,3,49,751,770,-19
114,3,50,819,690,129
114,3,51,799,962,-163
114,3,52,645,599,46
114,3,53,737,688,49
114,3,54,716,624,92
114,3,55,754,993,-239
114,3,56,759,677,82
114,3,57,920,599,321
114,3,58,704,891,-187
114,3,59,804,633,171
114,3,60,786,784,2
114,3,61,542,614,-72
114,3,62,1279,857,422
114,3,63,1246,653,593
114,3,64,738,618,120
114,3,65,776,678,98
114,3,66,1095,644,451
114,3,67,884,625,259
114,3,68,887,723,164
114,3,69,719,730,-11
114,3,70,776,678,98
114,3,71,746,653,93
114,3,72,1045,716,329
115,3,1,1126,1327,-201
115,3,2,1061,1263,-202
115,3,3,1230,1163,67
115,3,4,1406,1187,219
115,3,5,961,1283,-322
115,3,6,1116,1099,17
115,3,7,1043,1050,-7
115,3,8,1041,1404,-363
115,3,9,1035,1094,-59
115,3,10,969,1129,-160
115,3,11,950,1235,-285
115,3,12,995,1198,-203
115,3,13,1397,1172,225
115,3,14,1092,1011,81
115,3,15,1155,1023,132
115,3,16,997,1018,-21
115,3,17,1023,1002,21
115,3,18,953,1120,-167
115,3,19,914,991,-77
115,3,20,1029,980,49
115,3,21,969,1181,-212
115,3,22,983,1031,-48
115,3,23,1057,973,84
115,3,24,1002,960,42
115,3,25,1160,1128,32
115,3,26,938,1188,-250
115,3,27,965,1083,-118
115,3,28,1051,1078,-27
115,3,29,967,1051,-84
115,3,30,913,985,-72
115,3,31,1169,977,192
115,3,32,1022,1014,8
115,3,33,1015,1089,-74
115,3,34,998,1034,-36
115,3,35,1161,1020,141
115,3,36,1000,1352,-352
115,3,37,1455,1094,361
115,3,38,1013,965,48
115,3,39,986,983,3
115,3,40,1025,981,44
115,3,41,931,1036,-105
115,3,42,1146,948,198
115,3,43,871,985,-114
115,3,44,889,935,-46
115,3,45,1012,1155,-143
115,3,46,871,1042,-171
115,3,47,949,1118,-169
115,3,48,938,947,-9
115,3,49,1071,1082,-11
115,3,50,1000,1203,-203
115,3,51,993,921,72
115,3,52,1087,1079,8
115,3,53,1072,1121,-49
115,3,54,978,1014,-36
115,3,55,1122,1010,112
115,3,56,1038,1071,-33
115,3,57,985,1017,-32
115,3,58,1017,1206,-189
115,3,59,919,995,-76
115,3,60,1000,1106,-106
115,3,61,965,1115,-150
115,3,62,1060,1061,-1
115,3,63,950,974,-24
115,3,64,1027,1027,0
115,3,65,937,988,-51
115,3,66,1219,1209,10
115,3,67,952,1062,-110
115,3,68,1077,1096,-19
115,3,69,935,1088,-153
115,3,70,1247,1149,98
115,3,71,1004,954,50
115,3,72,1089,972,117
116,3,1,1044,1196,-152
116,3,3,1023,1037,-14
116,3,4,1023,785,238
116,3,5,1021,730,291
116,3,6,1125,783,342
116,3,7,1121,897,224
116,3,9,945,824,121
116,3,11,997,771,226
116,3,12,1058,836,222
116,3,13,1021,1133,-112
116,3,14,961,749,212
116,3,15,976,808,168
116,3,16,1100,772,328
116,3,17,1101,779,322
116,3,18,961,793,168
116,3,19,1231,788,443
116,3,20,1319,681,638
116,3,21,1133,663,470
116,3,22,1716,854,862
116,3,23,813,814,-1
116,3,24,910,753,157
116,3,26,977,852,125
116,3,27,1078,798,280
116,3,28,1057,763,294
116,3,29,1240,751,489
116,3,30,924,927,-3
116,3,31,1825,996,829
116,3,32,1870,1621,249
116,3,33,1615,756,859
116,3,34,1200,794,406
116,3,36,1039,893,146
116,3,37,1079,974,105
116,3,38,1660,746,914
116,3,39,1158,714,444
116,3,40,738,1047,-309
116,3,41,780,730,50
116,3,42,1058,805,253
116,3,43,1676,718,958
116,3,44,891,736,155
116,3,45,1000,745,255
116,3,46,1105,796,309
116,3,47,1750,900,850
116,3,48,1405,814,591
116,3,49,1272,633,639
116,3,50,852,744,108
116,3,52,1011,699,312
116,3,53,1099,748,351
116,3,54,908,718,190
116,3,55,808,657,151
116,3,57,1179,690,489
116,3,58,930,713,217
116,3,59,1080,749,331
116,3,60,961,723,238
116,3,61,866,750,116
116,3,63,865,802,63
116,3,64,944,786,158
116,3,65,817,789,28
116,3,66,757,1193,-436
116,3,67,986,761,225
116,3,68,933,684,249
116,3,69,1197,556,641
116,3,71,864,767,97
116,3,72,881,792,89
117,2,1,888,1255,-367
117,2,2,1033,991,42
117,2,3,1083,1187,-104
117,2,4,933,1122,-189
117,2,5,1040,1027,13
117,2,6,978,1111,-133
117,2,7,1037,948,89
117,2,8,964,1032,-68
117,2,9,882,1491,-609
117,2,10,1028,1304,-276
117,2,11,840,992,-152
117,2,12,921,861,60
117,2,13,888,1135,-247
117,2,14,881,926,-45
117,2,15,944,917,27
117,2,16,942,1026,-84
117,2,17,1106,1071,35
117,2,18,832,1019,-187
117,2,19,816,798,18
117,2,21,866,1002,-136
117,2,22,833,889,-56
117,2,23,852,848,4
117,2,24,798,978,-180
117,2,25,883,881,2
117,2,26,843,1022,-179
117,2,27,990,1004,-14
117,2,28,896,1057,-161
117,2,29,894,940,-46
117,2,30,798,931,-133
117,2,31,787,853,-66
117,2,32,992,941,51
117,2,33,796,1074,-278
117,2,34,909,830,79
117,2,35,843,874,-31
117,2,36,800,1022,-222
117,2,37,1160,1225,-65
117,2,38,950,1059,-109
117,2,39,774,978,-204
117,2,40,808,1009,-201
117,2,41,874,873,1
117,2,43,923,920,3
117,2,44,856,970,-114
117,2,45,768,615,153
117,2,46,764,1032,-268
117,2,47,1387,846,541
117,2,48,889,960,-71
117,2,49,1227,847,380
117,2,50,973,890,83
117,2,51,756,872,-116
117,2,52,807,807,0
117,2,53,844,1003,-159
117,2,54,780,991,-211
117,2,55,867,975,-108
117,2,56,842,810,32
117,2,57,761,905,-144
117,2,58,814,1236,-422
117,2,59,1116,816,300
117,2,60,810,863,-53
117,2,61,731,920,-189
117,2,62,819,453,366
117,2,63,748,830,-82
117,2,64,566,920,-354
117,2,65,883,1000,-117
117,2,67,783,1000,-217
117,2,68,804,946,-142
117,2,69,830,960,-130
117,2,70,455,1001,-546
117,2,71,733,1036,-303
117,2,72,810,938,-128
118,2,1,1308,1426,-118
118,2,2,1064,1256,-192
118,2,3,1329,1606,-277
118,2,4,1157,1914,-757
118,2,5,1011,1179,-168
118,2,6,1088,1129,-41
118,2,7,990,1065,-75
118,2,8,1004,400,604
118,2,9,1110,360,750
118,2,10,1427,414,1013
118,2,11,1031,294,737
118,2,12,879,321,558
118,2,13,972,307,665
118,2,14,933,239,694
118,2,15,906,324,582
118,2,16,964,153,811
118,2,17,1028,334,694
118,2,18,992,353,639
118,2,19,874,196,678
118,2,20,1161,97,1064
118,2,21,885,420,465
118,2,22,823,372,451
118,2,23,815,272,543
118,2,24,840,233,607
118,2,25,1052,494,558
118,2,26,918,418,500
118,2,27,1332,156,1176
118,2,28,824,65,759
118,2,30,808,150,658
118,2,31,1198,192,1006
118,2,32,888,255,633
118,2,33,919,134,785
118,2,34,835,247,588
118,2,35,898,302,596
118,2,36,1032,392,640
118,2,37,748,184,564
118,2,38,746,277,469
118,2,39,1308,312,996
118,2,40,873,343,530
118,2,41,856,296,560
118,2,42,775,48,727
118,2,43,834,214,620
118,2,44,872,275,597
118,2,45,839,426,413
118,2,46,909,405,504
118,2,47,903,208,695
118,2,48,836,336,500
118,2,49,803,245,558
118,2,50,598,113,485
118,2,51,766,168,598
118,2,52,801,154,647
118,2,54,1186,598,588
118,2,55,844,222,622
118,2,56,812,409,403
118,2,57,924,53,871
118,2,58,883,99,784
118,2,59,1106,299,807
118,2,60,836,58,778
118,2,61,836,272,564
118,2,62,886,197,689
118,2,63,748,400,348
118,2,64,946,369,577
118,2,65,866,726,140
118,2,66,997,162,835
118,2,67,1030,258,772
118,2,68,970,26,944
118,2,69,905,332,573
118,2,70,791,161,630
118,2,71,1040,309,731
118,2,72,877,445,432
119,2,1,1007,1406,-399
119,2,2,1107,1090,17
119,2,4,1165,1173,-8
119,2,5,997,1342,-345
119,2,7,1012,1504,-492
119,2,8,1104,1060,44
119,2,9,1040,1362,-322
119,2,10,1176,1211,-35
119,2,11,1099,1077,22
119,2,12,1077,1298,-221
119,2,13,1195,1221,-26
119,2,14,938,1301,-363
119,2,15,957,1049,-92
119,2,16,935,1130,-195
119,2,17,971,1311,-340
119,2,18,860,935,-75
119,2,19,932,709,223
119,2,20,874,1269,-395
119,2,21,968,1089,-121
119,2,22,903,1025,-122
119,2,23,1020,1133,-113
119,2,24,1104,1016,88
119,2,25,999,1259,-260
119,2,26,971,1243,-272
119,2,27,951,998,-47
119,2,28,954,1245,-291
119,2,29,902,960,-58
119,2,30,964,756,208
119,2,31,1192,922,270
119,2,33,889,1007,-118
119,2,35,1081,1028,53
119,2,36,1031,1193,-162
119,2,37,1429,1140,289
119,2,39,900,1045,-145
119,2,40,893,1237,-344
119,2,41,933,1576,-643
119,2,42,984,928,56
119,2,43,1076,1003,73
119,2,44,1122,820,302
119,2,45,959,1361,-402
119,2,46,1087,1134,-47
119,2,47,942,1481,-539
119,2,48,982,809,173
119,2,50,1069,1485,-416
119,2,51,1018,1189,-171
119,2,52,968,886,82
119,2,53,1040,1212,-172
119,2,54,1050,1229,-179
119,2,55,1260,1256,4
119,2,56,1074,1159,-85
119,2,57,838,816,22
119,2,58,1108,1319,-211
119,2,59,1245,1358,-113
119,2,60,994,1220,-226
119,2,61,1024,1048,-24
119,2,62,1170,1141,29
119,2,63,940,1069,-129
119,2,64,1011,1205,-194
119,2,65,1019,1142,-123
119,2,66,928,1131,-203
119,2,67,764,1198,-434
119,2,68,1648,1297,351
119,2,69,1105,1169,-64
119,2,70,857,1547,-690
119,2,71,1144,1586,-442
119,2,72,1229,1510,-281
120,2,1,938,1135,-197
120,2,2,875,803,72
120,2,3,917,749,168
120,2,4,809,718,91
120,2,5,854,798,56
120,2,6,1113,921,192
120,2,7,883,815,68
120,2,8,818,665,153
120,2,9,799,785,14
120,2,10,766,780,-14
120,2,11,727,653,74
120,2,12,772,653,119
120,2,13,853,709,144
120,2,14,778,771,7
120,2,15,738,681,57
120,2,16,703,663,40
120,2,17,811,706,105
120,2,18,762,874,-112
120,2,19,726,634,92
120,2,20,780,794,-14
120,2,21,847,667,180
120,2,22,806,736,70
120,2,23,677,717,-40
120,2,24,709,599,110
120,2,25,810,630,180
120,2,26,749,634,115
120,2,27,767,727,40
120,2,28,693,886,-193
120,2,29,778,674,104
120,2,30,692,691,1
120,2,31,756,747,9
120,2,32,701,708,-7
120,2,33,826,707,119
120,2,34,800,730,70
120,2,36,748,697,51
120,2,37,734,716,18
120,2,38,689,712,-23
120,2,39,824,685,139
120,2,40,797,678,119
120,2,41,826,731,95
120,2,42,736,662,74
120,2,43,807,646,161
120,2,44,674,636,38
120,2,45,737,671,66
120,2,46,828,803,25
120,2,47,695,640,55
120,2,48,718,687,31
120,2,49,773,603,170
120,2,50,656,622,34
120,2,51,706,657,49
120,2,52,755,687,68
120,2,53,759,683,76
120,2,54,684,720,-36
120,2,55,742,693,49
120,2,56,773,652,121
120,2,57,788,675,113
120,2,58,730,642,88
120,2,59,615,646,-31
120,2,60,709,659,50
120,2,61,721,847,-126
120,2,62,649,794,-145
120,2,63,782,634,148
120,2,64,755,607,148
120,2,66,671,694,-23
120,2,67,1451,630,821
120,2,68,665,610,55
120,2,69,650,672,-22
120,2,70,695,606,89
120,2,71,784,661,123
120,2,72,778,633,145
121,2,1,1030,1127,-97
121,2,2,1085,1060,25
121,2,3,827,1164,-337
121,2,4,956,815,141
121,2,5,873,850,23
121,2,6,1078,752,326
121,2,7,847,887,-40
121,2,8,911,747,164
121,2,9,916,821,95
121,2,10,930,876,54
121,2,11,812,813,-1
121,2,12,797,728,69
121,2,13,1060,942,118
121,2,14,1086,973,113
121,2,15,1012,942,70
121,2,16,980,996,-16
121,2,17,1060,957,103
121,2,18,869,1130,-261
121,2,19,910,992,-82
121,2,20,1118,846,272
121,2,21,1149,896,253
121,2,22,949,1100,-151
121,2,23,1133,1016,117
121,2,24,1106,996,110
121,2,25,970,1107,-137
121,2,26,927,1032,-105
121,2,27,1196,998,198
121,2,28,1057,1010,47
121,2,29,1012,989,23
121,2,30,1160,919,241
121,2,31,1047,1039,8
121,2,32,973,1347,-374
121,2,33,987,1019,-32
121,2,34,1122,1169,-47
121,2,35,1015,838,177
121,2,36,988,1050,-62
121,2,37,1037,820,217
121,2,38,934,826,108
121,2,39,908,822,86
121,2,40,924,828,96
121,2,41,1188,1008,180
121,2,42,941,893,48
121,2,43,980,934,46
121,2,44,1206,910,296
121,2,45,943,809,134
121,2,46,851,939,-88
121,2,47,1196,829,367
121,2,48,1000,963,37
121,2,49,1034,947,87
121,2,50,974,1248,-274
121,2,51,931,1046,-115
121,2,52,1017,931,86
121,2,53,893,1102,-209
121,2,54,1007,808,199
121,2,55,1103,1285,-182
121,2,56,930,883,47
121,2,57,1069,920,149
121,2,58,1329,1386,-57
121,2,59,918,927,-9
121,2,60,1083,1229,-146
121,2,61,1042,1217,-175
121,2,62,1006,1010,-4
121,2,63,997,873,124
121,2,64,1074,1594,-520
121,2,65,1004,903,101
121,2,66,1000,962,38
121,2,67,1047,1058,-11
121,2,68,999,1135,-136
121,2,69,1335,873,462
121,2,70,1092,1039,53
121,2,71,1288,936,352
121,2,72,1061,1158,-97
122,2,1,1021,1075,-54
122,2,2,890,967,-77
122,2,3,893,859,34
122,2,4,762,788,-26
122,2,5,913,748,165
122,2,6,892,808,84
122,2,7,790,754,36
122,2,8,828,809,19
122,2,9,963,901,62
122,2,10,849,782,67
122,2,11,753,932,-179
122,2,12,805,783,22
122,2,13,845,695,150
122,2,14,796,849,-53
122,2,15,808,835,-27
122,2,16,801,818,-17
122,2,17,768,809,-41
122,2,18,802,831,-29
122,2,19,769,810,-41
122,2,20,716,745,-29
122,2,21,726,866,-140
122,2,22,688,705,-17
122,2,23,792,714,78
122,2,24,628,704,-76
122,2,25,785,723,62
122,2,26,761,759,2
122,2,27,773,756,17
122,2,28,817,676,141
122,2,29,749,700,49
122,2,30,771,754,17
122,2,31,742,816,-74
122,2,32,790,707,83
122,2,33,789,715,74
122,2,34,729,693,36
122,2,35,759,664,95
122,2,36,727,669,58
122,2,37,1172,666,506
122,2,38,821,714,107
122,2,39,698,674,24
122,2,40,642,640,2
122,2,41,774,731,43
122,2,42,791,733,58
122,2,43,739,703,36
122,2,44,706,834,-128
122,2,45,578,501,77
122,2,46,598,558,40
122,2,47,766,676,90
122,2,48,861,751,110
122,2,49,683,672,11
122,2,50,724,663,61
122,2,52,726,730,-4
122,2,53,721,659,62
122,2,54,720,753,-33
122,2,55,727,662,65
122,2,56,655,680,-25
122,2,57,704,702,2
122,2,58,542,657,-115
122,2,59,687,694,-7
122,2,60,702,749,-47
122,2,61,492,631,-139
122,2,62,748,682,66
122,2,63,716,649,67
122,2,64,697,431,266
122,2,65,747,421,326
122,2,66,635,707,-72
122,2,67,731,417,314
122,2,68,855,442,413
122,2,69,690,468,222
122,2,70,741,541,200
122,2,71,744,422,322
122,2,72,465,397,68
123,3,1,885,1105,-220
123,3,2,1120,1210,-90
123,3,3,1010,1024,-14
123,3,5,1209,1058,151
123,3,6,1223,866,357
123,3,7,1089,921,168
123,3,8,933,905,28
123,3,9,974,911,63
123,3,10,894,936,-42
123,3,11,1005,953,52
123,3,12,1129,985,144
123,3,13,880,871,9
123,3,14,965,889,76
123,3,15,945,1021,-76
123,3,16,1428,927,501
123,3,17,1108,903,205
123,3,18,965,935,30
123,3,19,1085,964,121
123,3,20,1020,955,65
123,3,21,848,1052,-204
123,3,22,917,816,101
123,3,23,1081,1072,9
123,3,24,1616,977,639
123,3,25,917,992,-75
123,3,26,990,984,6
123,3,27,1076,820,256
123,3,28,901,851,50
123,3,29,845,899,-54
123,3,30,886,867,19
123,3,31,1028,1037,-9
123,3,32,1090,1009,81
123,3,33,835,998,-163
123,3,34,945,1066,-121
123,3,35,936,973,-37
123,3,36,949,826,123
123,3,37,938,874,64
123,3,38,942,940,2
123,3,39,1015,1278,-263
123,3,40,856,1047,-191
123,3,41,891,836,55
123,3,42,861,906,-45
123,3,43,921,1017,-96
123,3,44,797,950,-153
123,3,45,881,980,-99
123,3,46,866,920,-54
123,3,47,776,845,-69
123,3,48,885,923,-38
123,3,49,1098,1015,83
123,3,50,852,900,-48
123,3,51,908,908,0
123,3,52,980,1134,-154
123,3,53,837,893,-56
123,3,54,848,934,-86
123,3,55,869,1059,-190
123,3,56,849,1292,-443
123,3,57,819,1071,-252
123,3,58,878,1076,-198
123,3,59,791,894,-103
123,3,60,791,945,-154
123,3,61,824,923,-99
123,3,62,760,1168,-408
123,3,63,824,1040,-216
123,3,64,703,925,-222
123,3,65,908,1054,-146
123,3,66,776,981,-205
123,3,67,708,927,-219
123,3,68,709,973,-264
123,3,69,686,890,-204
123,3,70,689,974,-285
123,3,71,651,903,-252
123,3,72,719,940,-221
124,2,1,770,882,-112
124,2,2,868,880,-12
124,2,3,753,877,-124
124,2,5,670,689,-19
124,2,6,794,730,64
124,2,7,717,762,-45
124,2,8,745,764,-19
124,2,9,810,759,51
124,2,10,768,736,32
124,2,11,793,693,100
124,2,12,762,1074,-312
124,2,13,671,619,52
124,2,15,687,675,12
124,2,16,714,856,-142
124,2,17,679,629,50
124,2,18,809,767,42
124,2,19,706,565,141
124,2,20,666,762,-96
124,2,21,649,656,-7
124,2,22,801,675,126
124,2,23,709,618,91
124,2,24,815,627,188
124,2,26,748,658,90
124,2,27,803,673,130
124,2,28,689,668,21
124,2,29,705,633,72
124,2,30,710,606,104
124,2,31,599,758,-159
124,2,32,972,755,217
124,2,33,677,679,-2
124,2,34,755,613,142
124,2,35,725,692,33
124,2,36,719,595,124
124,2,37,1420,670,750
124,2,38,660,819,-159
124,2,39,696,577,119
124,2,40,557,446,111
124,2,41,524,368,156
124,2,42,635,273,362
124,2,43,749,298,451
124,2,44,677,740,-63
124,2,45,628,291,337
124,2,46,571,253,318
124,2,47,399,262,137
124,2,48,516,434,82
124,2,49,634,453,181
124,2,50,532,290,242
124,2,51,611,713,-102
124,2,53,467,232,235
124,2,54,407,23,384
124,2,55,492,68,424
124,2,56,457,150,307
124,2,57,493,248,245
124,2,59,514,254,260
124,2,60,587,44,543
124,2,61,638,337,301
124,2,63,575,62,513
124,2,64,606,351,255
124,2,65,597,306,291
124,2,66,573,303,270
124,2,67,655,317,338
124,2,68,568,238,330
124,2,69,600,142,458
124,2,70,562,686,-124
124,2,71,555,178,377
124,2,72,581,81,500
125,2,1,964,1284,-320
125,2,2,948,1268,-320
125,2,3,1120,1148,-28
125,2,4,1004,1149,-145
125,2,5,948,1046,-98
125,2,6,1056,996,60
125,2,7,952,592,360
125,2,8,1076,572,504
125,2,9,1152,1052,100
125,2,10,1324,1008,316
125,2,11,964,1072,-108
125,2,12,964,1024,-60
125,2,13,972,848,124
125,2,14,956,832,124
125,2,15,920,976,-56
125,2,16,996,840,156
125,2,17,948,920,28
125,2,18,956,924,32
125,2,19,996,996,0
125,2,20,956,857,99
125,2,21,923,948,-25
125,2,22,880,920,-40
125,2,23,908,1256,-348
125,2,24,880,924,-44
125,2,25,936,1144,-208
125,2,26,916,1204,-288
125,2,27,956,963,-7
125,2,28,928,1072,-144
125,2,29,988,952,36
125,2,30,952,988,-36
125,2,31,920,876,44
125,2,32,940,936,4
125,2,33,1032,1072,-40
125,2,34,928,1234,-306
125,2,35,1000,980,20
125,2,36,912,920,-8
125,2,37,828,1040,-212
125,2,38,980,1064,-84
125,2,39,932,848,84
125,2,40,856,920,-64
125,2,41,1016,1048,-32
125,2,42,1036,884,152
125,2,43,856,940,-84
125,2,44,1004,1004,0
125,2,45,876,972,-96
125,2,46,880,860,20
125,2,47,828,1092,-264
125,2,48,840,972,-132
125,2,49,1040,1096,-56
125,2,50,960,1072,-112
125,2,51,900,1080,-180
125,2,52,880,1108,-228
125,2,53,980,1236,-256
125,2,54,948,1184,-236
125,2,55,996,948,48
125,2,56,1028,928,100
125,2,57,1044,920,124
125,2,58,1024,896,128
125,2,59,868,840,28
125,2,60,868,868,0
125,2,61,892,980,-88
125,2,62,800,940,-140
125,2,63,884,1192,-308
125,2,64,899,908,-9
125,2,65,920,860,60
125,2,66,860,952,-92
125,2,67,956,920,36
125,2,68,905,1108,-203
125,2,69,808,868,-60
125,2,70,920,856,64
125,2,71,876,820,56
125,2,72,964,935,29
126,2,1,892,1137,-245
126,2,2,895,967,-72
126,2,3,927,1456,-529
126,2,4,872,946,-74
126,2,5,1027,1141,-114
126,2,6,946,812,134
126,2,7,1012,842,170
126,2,8,817,782,35
126,2,9,965,993,-28
126,2,10,967,1215,-248
126,2,11,909,839,70
126,2,12,864,844,20
126,2,13,968,1277,-309
126,2,15,905,821,84
126,2,16,840,767,73
126,2,18,888,801,87
126,2,19,893,1176,-283
126,2,20,931,1099,-168
126,2,21,902,1072,-170
126,2,22,892,1025,-133
126,2,23,848,789,59
126,2,24,844,899,-55
126,2,25,880,1195,-315
126,2,26,900,993,-93
126,2,27,755,809,-54
126,2,28,916,697,219
126,2,29,886,942,-56
126,2,30,801,895,-94
126,2,31,757,769,-12
126,2,32,871,952,-81
126,2,33,853,977,-124
126,2,34,810,1046,-236
126,2,35,755,963,-208
126,2,36,782,825,-43
126,2,37,727,1115,-388
126,2,38,772,984,-212
126,2,39,842,809,33
126,2,40,816,1254,-438
126,2,41,877,1050,-173
126,2,42,1027,856,171
126,2,43,976,1232,-256
126,2,44,1112,1612,-500
126,2,45,1094,1048,46
126,2,46,921,937,-16
126,2,47,753,924,-171
126,2,48,796,846,-50
126,2,49,872,927,-55
126,2,50,787,862,-75
126,2,52,960,959,1
126,2,53,1276,776,500
126,2,54,1004,1030,-26
126,2,55,905,685,220
126,2,56,874,1165,-291
126,2,57,826,1100,-274
126,2,58,702,1020,-318
126,2,59,826,1049,-223
126,2,60,834,860,-26
126,2,61,874,779,95
126,2,62,1458,729,729
126,2,63,865,875,-10
126,2,64,860,853,7
126,2,65,916,1133,-217
126,2,66,1088,897,191
126,2,67,910,979,-69
126,2,68,853,766,87
126,2,69,926,845,81
126,2,70,1034,842,192
126,2,71,807,780,27
126,2,72,1424,1032,392
127,1,1,915,980,-65
127,1,2,930,959,-29
127,1,3,754,1132,-378
127,1,4,762,904,-142
127,1,5,729,935,-206
127,1,6,838,1090,-252
127,1,7,747,807,-60
127,1,8,707,777,-70
127,1,9,752,717,35
127,1,10,773,768,5
127,1,11,1021,1001,20
127,1,12,860,936,-76
127,1,61,1520,1221,299
128,1,1,968,1319,-351
128,1,2,1074,1428,-354
128,1,3,1018,1219,-201
128,1,4,972,1010,-38
128,1,5,971,988,-17
128,1,6,1033,1019,14
128,1,7,1140,982,158
128,1,8,1117,1235,-118
128,1,9,1086,1526,-440
128,1,11,944,1142,-198
128,1,12,1022,1080,-58
128,1,14,1035,1205,-170
128,1,15,984,1033,-49
128,1,16,971,977,-6
128,1,17,1114,916,198
128,1,18,1065,1211,-146
128,1,19,1024,1016,8
128,1,20,1094,1044,50
128,1,21,930,939,-9
128,1,22,1121,1074,47
128,1,23,1082,1153,-71
128,1,24,337,603,-266
128,1,30,1049,1155,-106
128,1,31,1086,1027,59
128,1,33,1110,685,425
128,1,37,1395,469,926
128,1,38,989,286,703
128,1,39,447,390,57
128,1,40,322,315,7
128,1,41,379,370,9
128,1,43,999,297,702
128,1,44,451,304,147
128,1,46,658,484,174
128,1,47,904,363,541
128,1,48,782,544,238
128,1,49,1085,465,620
128,1,51,559,160,399
128,1,52,1148,400,748
128,1,53,1028,446,582
128,1,54,586,269,317
128,1,55,444,285,159
128,1,56,335,593,-258
128,1,57,602,139,463
128,1,58,398,437,-39
128,1,59,296,240,56
128,1,61,891,164,727
128,1,63,1018,333,685
128,1,64,583,331,252
128,1,66,1032,1081,-49
128,1,67,996,901,95
128,1,68,983,265,718
128,1,69,616,216,400
128,1,70,1056,460,596
129,2,2,880,1231,-351
129,2,3,824,1111,-287
129,2,4,869,1077,-208
129,2,5,973,1270,-297
129,2,6,869,1089,-220
129,2,7,845,996,-151
129,2,8,852,1054,-202
129,2,9,950,1087,-137
129,2,10,878,1008,-130
129,2,11,985,995,-10
129,2,12,1052,1016,36
129,2,13,858,923,-65
129,2,14,778,890,-112
129,2,17,873,931,-58
129,2,18,942,878,64
129,2,19,868,861,7
129,2,20,904,1011,-107
129,2,21,900,925,-25
129,2,22,876,948,-72
129,2,23,1061,1183,-122
129,2,24,938,997,-59
129,2,25,768,1049,-281
129,2,27,935,999,-64
129,2,28,1753,1040,713
129,2,30,845,1376,-531
129,2,31,874,1102,-228
129,2,32,970,1026,-56
129,2,33,1359,988,371
129,2,34,867,1037,-170
129,2,35,866,1052,-186
129,2,36,915,1026,-111
129,2,37,1312,954,358
129,2,39,1235,1318,-83
129,2,40,1107,930,177
129,2,41,1029,981,48
129,2,42,844,939,-95
129,2,43,1001,1132,-131
129,2,44,931,973,-42
129,2,45,1011,1066,-55
129,2,47,1014,1119,-105
129,2,48,847,983,-136
129,2,49,827,1339,-512
129,2,50,775,884,-109
129,2,51,809,1002,-193
129,2,52,813,966,-153
129,2,53,984,889,95
129,2,54,995,947,48
129,2,55,837,912,-75
129,2,56,936,1008,-72
129,2,57,901,1008,-107
129,2,58,1111,1040,71
129,2,59,829,862,-33
129,2,60,862,849,13
129,2,61,824,1050,-226
129,2,62,1102,881,221
129,2,63,839,929,-90
129,2,64,883,919,-36
129,2,65,965,906,59
129,2,66,804,935,-131
129,2,67,869,833,36
129,2,68,889,826,63
129,2,69,908,975,-67
129,2,70,825,971,-146
129,2,71,911,871,40
129,2,72,870,918,-48
130,2,1,1128,1038,90
130,2,2,899,982,-83
130,2,3,954,871,83
130,2,4,1014,914,100
130,2,5,1115,1058,57
130,2,6,1035,986,49
130,2,7,1325,990,335
130,2,8,1021,916,105
130,2,9,1131,939,192
130,2,10,1149,872,277
130,2,11,1065,1149,-84
130,2,12,1400,918,482
130,2,13,1018,953,65
130,2,14,1004,1087,-83
130,2,15,946,981,-35
130,2,16,1054,957,97
130,2,17,941,996,-55
130,2,18,979,930,49
130,2,19,901,921,-20
130,2,20,1165,1060,105
130,2,21,986,1031,-45
130,2,22,935,946,-11
130,2,23,960,1083,-123
130,2,24,895,926,-31
130,2,25,1066,834,232
130,2,26,1050,1108,-58
130,2,27,873,969,-96
130,2,28,884,1014,-130
130,2,29,933,953,-20
130,2,30,1003,836,167
130,2,31,910,911,-1
130,2,32,896,929,-33
130,2,33,993,923,70
130,2,34,849,874,-25
130,2,35,997,951,46
130,2,36,899,935,-36
130,2,37,886,1104,-218
130,2,38,928,886,42
130,2,39,909,906,3
130,2,40,961,1060,-99
130,2,41,885,907,-22
130,2,42,881,795,86
130,2,43,998,895,103
130,2,44,1007,1017,-10
130,2,45,931,1015,-84
130,2,46,1146,867,279
130,2,47,1251,1000,251
130,2,48,949,901,48
130,2,49,853,1098,-245
130,2,50,961,1140,-179
130,2,51,930,1040,-110
130,2,52,961,959,2
130,2,53,1035,878,157
130,2,54,599,838,-239
130,2,55,866,1044,-178
130,2,56,629,1158,-529
130,2,57,1070,958,112
130,2,58,545,1268,-723
130,2,59,908,1051,-143
130,2,60,917,933,-16
130,2,61,880,929,-49
130,2,62,890,891,-1
130,2,63,888,897,-9
130,2,64,885,934,-49
130,2,65,943,977,-34
130,2,66,868,836,32
130,2,67,1276,1013,263
130,2,68,853,952,-99
130,2,69,910,952,-42
130,2,70,1050,915,135
130,2,71,999,994,5
130,2,72,957,915,42
131,1,3,1827,1957,-130
131,1,5,1774,1862,-88
131,1,9,1830,1983,-153
131,1,10,1730,1763,-33
131,1,11,1759,1721,38
131,1,12,1830,1703,127
131,1,13,1792,1931,-139
131,1,14,1773,1870,-97
131,1,15,1754,1782,-28
131,1,17,1809,1709,100
131,1,18,1772,1819,-47
131,1,20,1755,1756,-1
131,1,21,1759,1974,-215
131,1,22,1739,1904,-165
131,1,23,1793,1913,-120
131,1,24,1711,1766,-55
131,1,26,1858,1787,71
131,1,27,1823,1745,78
131,1,28,1734,1731,3
131,1,29,1879,1761,118
131,1,30,1939,1893,46
131,1,31,1704,1924,-220
131,1,32,1696,1731,-35
131,1,33,1733,1783,-50
131,1,34,1691,1650,41
131,1,36,1733,2002,-269
131,1,38,1701,1728,-27
131,1,39,1738,1620,118
131,1,40,1622,1728,-106
131,1,42,1773,1611,162
131,1,43,1720,1687,33
131,1,45,1758,1689,69
131,1,46,1751,1697,54
131,1,47,1714,1844,-130
131,1,48,1707,1705,2
131,1,49,1950,1684,266
131,1,51,1733,1718,15
131,1,52,1626,1724,-98
131,1,54,1673,1770,-97
131,1,55,1720,1700,20
131,1,57,1731,1680,51
131,1,58,1692,1708,-16
131,1,60,1730,1680,50
131,1,61,1761,1832,-71
131,1,62,1752,1688,64
131,1,63,1709,1683,26
131,1,64,1733,1651,82
131,1,65,1740,1672,68
131,1,66,1698,1605,93
131,1,67,1667,1754,-87
131,1,68,1815,1909,-94
131,1,69,1761,1728,33
131,1,70,1903,1676,227
131,1,71,1705,1648,57
132,3,1,751,903,-152
132,3,2,671,852,-181
132,3,3,708,656,52
132,3,4,660,670,-10
132,3,5,731,702,29
132,3,6,808,737,71
132,3,7,703,663,40
132,3,8,818,809,9
132,3,9,800,653,147
132,3,10,693,746,-53
132,3,11,701,635,66
132,3,12,792,674,118
132,3,13,873,723,150
132,3,14,753,725,28
132,3,15,810,678,132
132,3,16,808,758,50
132,3,17,743,659,84
132,3,18,808,693,115
132,3,19,700,669,31
132,3,20,759,590,169
132,3,21,795,598,197
132,3,22,868,665,203
132,3,23,730,615,115
132,3,24,778,652,126
132,3,25,713,664,49
132,3,26,779,851,-72
132,3,27,808,758,50
132,3,28,753,629,124
132,3,29,743,697,46
132,3,30,823,636,187
132,3,31,772,669,103
132,3,32,706,746,-40
132,3,33,738,695,43
132,3,34,761,780,-19
132,3,35,714,759,-45
132,3,36,702,682,20
132,3,37,698,769,-71
132,3,38,727,690,37
132,3,39,661,682,-21
132,3,40,725,675,50
132,3,41,808,745,63
132,3,42,661,729,-68
132,3,43,874,680,194
132,3,44,850,664,186
132,3,45,659,670,-11
132,3,46,745,727,18
132,3,47,709,837,-128
132,3,48,990,1099,-109
132,3,49,731,665,66
132,3,50,709,655,54
132,3,51,826,641,185
132,3,52,754,780,-26
132,3,53,703,647,56
132,3,54,753,691,62
132,3,55,804,802,2
132,3,56,798,909,-111
132,3,57,696,818,-122
132,3,58,786,606,180
132,3,59,733,828,-95
132,3,60,663,1164,-501
132,3,61,818,860,-42
132,3,62,696,770,-74
132,3,63,825,864,-39
132,3,64,930,840,90
132,3,65,793,872,-79
132,3,66,755,838,-83
132,3,67,813,884,-71
132,3,68,796,673,123
132,3,69,744,643,101
132,3,70,732,601,131
132,3,71,926,697,229
132,3,72,745,636,109
133,1,14,977,969,8
133,1,15,1074,1043,31
133,1,22,1057,1068,-11
133,1,25,1545,801,744
133,1,26,871,617,254
133,1,27,1163,1166,-3
133,1,28,944,658,286
133,1,32,1010,612,398
133,1,39,1490,1018,472
133,1,40,718,712,6
133,1,41,977,649,328
133,1,42,778,781,-3
133,1,44,1623,656,967
133,1,45,766,1323,-557
133,1,46,701,719,-18
133,1,48,807,777,30
133,1,52,714,650,64
133,1,53,776,705,71
133,1,54,744,625,119
133,1,55,961,762,199
133,1,56,790,615,175
133,1,57,905,819,86
133,1,58,893,582,311
133,1,59,761,603,158
133,1,60,712,723,-11
133,1,61,716,724,-8
133,1,62,685,687,-2
133,1,63,791,648,143
133,1,64,756,639,117
133,1,65,772,670,102
133,1,66,709,622,87
133,1,67,728,632,96
133,1,68,698,620,78
133,1,69,715,651,64
133,1,70,713,652,61
133,1,71,713,676,37
133,1,72,712,1089,-377
134,2,1,1096,1173,-77
134,2,2,840,1063,-223
134,2,3,965,1072,-107
134,2,4,1058,975,83
134,2,5,891,1499,-608
134,2,6,971,955,16
134,2,7,913,860,53
134,2,8,855,794,61
134,2,9,933,993,-60
134,2,10,746,1042,-296
134,2,11,807,889,-82
134,2,12,982,896,86
134,2,13,923,1661,-738
134,2,14,848,1153,-305
134,2,15,1093,937,156
134,2,16,820,924,-104
134,2,17,873,977,-104
134,2,18,824,824,0
134,2,19,834,1098,-264
134,2,20,884,869,15
134,2,21,778,756,22
134,2,22,781,875,-94
134,2,23,859,924,-65
134,2,24,987,788,199
134,2,25,946,892,54
134,2,26,821,1125,-304
134,2,27,789,821,-32
134,2,28,821,837,-16
134,2,29,902,950,-48
134,2,30,885,926,-41
134,2,31,632,836,-204
134,2,32,918,872,46
134,2,33,1004,1005,-1
134,2,35,808,890,-82
134,2,36,737,824,-87
134,2,37,1036,845,191
134,2,38,1391,840,551
134,2,39,783,816,-33
134,2,40,841,930,-89
134,2,41,963,1092,-129
134,2,42,800,838,-38
134,2,43,761,819,-58
134,2,44,649,764,-115
134,2,45,786,867,-81
134,2,46,750,915,-165
134,2,47,788,724,64
134,2,48,678,926,-248
134,2,49,804,854,-50
134,2,50,723,833,-110
134,2,51,828,868,-40
134,2,52,843,877,-34
134,2,53,1000,849,151
134,2,54,829,846,-17
134,2,55,916,797,119
134,2,56,779,701,78
134,2,57,972,788,184
134,2,58,900,674,226
134,2,59,866,891,-25
134,2,60,975,904,71
134,2,61,846,797,49
134,2,62,717,909,-192
134,2,63,837,925,-88
134,2,64,850,808,42
134,2,65,822,856,-34
134,2,66,768,697,71
134,2,67,897,938,-41
134,2,68,865,857,8
134,2,69,866,885,-19
134,2,70,795,842,-47
134,2,71,881,827,54
134,2,72,818,1004,-186
135,2,1,1104,1241,-137
135,2,2,973,1014,-41
135,2,3,970,1108,-138
135,2,4,848,740,108
135,2,5,1067,771,296
135,2,6,1019,892,127
135,2,7,784,739,45
135,2,8,886,1014,-128
135,2,9,660,757,-97
135,2,10,771,790,-19
135,2,11,811,748,63
135,2,12,734,756,-22
135,2,13,693,774,-81
135,2,14,664,761,-97
135,2,15,1368,1002,366
135,2,16,835,835,0
135,2,17,941,964,-23
135,2,18,852,750,102
135,2,19,774,808,-34
135,2,20,813,744,69
135,2,21,822,717,105
135,2,22,734,655,79
135,2,23,800,714,86
135,2,25,651,796,-145
135,2,26,918,862,56
135,2,27,963,1209,-246
135,2,28,1418,1435,-17
135,2,29,795,918,-123
135,2,30,857,783,74
135,2,31,1065,1068,-3
135,2,32,745,729,16
135,2,33,769,1180,-411
135,2,35,851,1987,-1136
135,2,36,862,752,110
135,2,37,799,703,96
135,2,38,691,693,-2
135,2,40,724,701,23
135,2,41,747,661,86
135,2,42,752,830,-78
135,2,45,673,979,-306
135,2,46,802,955,-153
135,2,47,756,814,-58
135,2,48,731,761,-30
135,2,50,744,784,-40
135,2,51,806,719,87
135,2,52,785,651,134
135,2,53,739,1388,-649
135,2,54,816,1089,-273
135,2,55,801,979,-178
135,2,56,681,665,16
135,2,57,677,767,-90
135,2,58,966,869,97
135,2,59,1122,1043,79
135,2,61,837,1033,-196
135,2,62,1266,861,405
135,2,64,839,792,47
135,2,66,685,686,-1
135,2,67,963,732,231
135,2,68,655,672,-17
135,2,69,667,702,-35
135,2,71,900,765,135
135,2,72,781,862,-81
136,1,1,1055,1127,-72
136,1,2,1224,1115,109
136,1,3,1015,1180,-165
136,1,4,1142,1164,-22
136,1,5,1201,1118,83
136,1,6,887,1039,-152
136,1,7,1019,1046,-27
136,1,8,1233,1137,96
136,1,10,853,908,-55
136,1,11,987,1029,-42
136,1,12,1051,1055,-4
136,1,13,1096,1011,85
136,1,14,853,942,-89
136,1,15,827,1073,-246
136,1,16,966,982,-16
136,1,17,1019,932,87
136,1,18,917,1067,-150
136,1,19,1295,1043,252
136,1,20,1866,1608,258
136,1,21,1101,1106,-5
136,1,22,946,925,21
136,1,23,864,1216,-352
136,1,24,1020,1196,-176
136,1,25,1194,1340,-146
136,1,27,968,1054,-86
136,1,28,1067,1048,19
136,1,29,1070,1123,-53
136,1,30,1109,1171,-62
136,1,31,1179,1354,-175
136,1,32,867,1074,-207
136,1,33,524,1043,-519
136,1,35,999,1249,-250
136,1,36,1109,1007,102
136,1,37,1280,1178,102
136,1,38,1398,1040,358
136,1,39,670,543,127
136,1,40,1028,1133,-105
136,1,41,1235,461,774
136,1,42,490,478,12
136,1,43,424,1240,-816
136,1,44,1175,1218,-43
136,1,45,651,447,204
136,1,46,1097,1236,-139
136,1,47,674,1214,-540
136,1,48,533,1364,-831
136,1,49,1273,543,730
136,1,50,1054,607,447
136,1,51,743,1285,-542
136,1,52,1224,1315,-91
136,1,53,1049,1294,-245
136,1,54,1268,592,676
136,1,55,1078,250,828
136,1,56,753,588,165
136,1,57,899,417,482
136,1,58,1246,1215,31
136,1,59,1152,325,827
136,1,62,1537,1294,243
136,1,63,1893,1073,820
136,1,64,948,963,-15
136,1,65,1593,1167,426
136,1,66,1185,1190,-5
136,1,67,1552,1160,392
136,1,68,1130,1356,-226
136,1,69,1028,572,456
136,1,70,1385,1093,292
136,1,71,1106,1212,-106
136,1,72,1003,574,429
137,3,1,925,1158,-233
137,3,2,970,1201,-231
137,3,3,889,1105,-216
137,3,4,906,1151,-245
137,3,5,1086,952,134
137,3,6,1042,1197,-155
137,3,7,961,995,-34
137,3,8,999,1033,-34
137,3,9,1053,1236,-183
137,3,10,1070,933,137
137,3,11,824,904,-80
137,3,12,1120,1439,-319
137,3,13,1176,883,293
137,3,14,1122,1036,86
137,3,15,1003,1265,-262
137,3,16,1423,1279,144
137,3,17,1305,1146,159
137,3,19,902,1011,-109
137,3,20,930,1173,-243
137,3,21,878,938,-60
137,3,22,954,1022,-68
137,3,23,950,951,-1
137,3,24,1105,1001,104
137,3,25,803,966,-163
137,3,26,784,972,-188
137,3,27,967,844,123
137,3,28,767,955,-188
137,3,29,942,1014,-72
137,3,30,1022,1020,2
137,3,31,954,1063,-109
137,3,32,1295,1144,151
137,3,33,917,994,-77
137,3,34,1635,1379,256
137,3,35,1094,991,103
137,3,36,1327,1522,-195
137,3,37,1127,1168,-41
137,3,38,1715,1259,456
137,3,39,1042,931,111
137,3,40,886,872,14
137,3,41,1041,1297,-256
137,3,42,967,972,-5
137,3,44,803,924,-121
137,3,45,868,867,1
137,3,47,1043,1018,25
137,3,48,861,869,-8
137,3,49,756,898,-142
137,3,50,791,797,-6
137,3,51,864,882,-18
137,3,52,822,991,-169
137,3,53,742,934,-192
137,3,54,803,860,-57
137,3,55,917,1274,-357
137,3,56,1140,1274,-134
137,3,57,820,893,-73
137,3,58,806,1036,-230
137,3,59,1047,857,190
137,3,60,1014,962,52
137,3,61,1061,1012,49
137,3,62,1466,997,469
137,3,63,1066,1078,-12
137,3,64,1012,1454,-442
137,3,65,997,1150,-153
137,3,66,811,897,-86
137,3,67,949,1119,-170
137,3,68,840,938,-98
137,3,69,836,1110,-274
137,3,70,906,1035,-129
137,3,71,866,942,-76
138,3,1,1396,1478,-82
138,3,2,952,1473,-521
138,3,3,1120,1394,-274
138,3,4,901,1042,-141
138,3,5,1050,1789,-739
138,3,6,865,1124,-259
138,3,7,927,1111,-184
138,3,8,881,1252,-371
138,3,9,761,920,-159
138,3,10,893,761,132
138,3,11,875,613,262
138,3,12,875,797,78
138,3,13,870,768,102
138,3,14,794,755,39
138,3,15,870,872,-2
138,3,16,796,700,96
138,3,17,944,954,-10
138,3,18,873,970,-97
138,3,19,915,573,342
138,3,20,896,817,79
138,3,21,880,799,81
138,3,22,759,644,115
138,3,24,821,734,87
138,3,25,823,864,-41
138,3,26,730,676,54
138,3,27,852,756,96
138,3,28,827,819,8
138,3,29,852,780,72
138,3,30,726,775,-49
138,3,31,803,615,188
138,3,32,755,910,-155
138,3,33,916,813,103
138,3,34,938,761,177
138,3,35,821,691,130
138,3,36,972,743,229
138,3,37,900,782,118
138,3,38,773,620,153
138,3,39,1007,802,205
138,3,40,819,650,169
138,3,41,853,695,158
138,3,42,710,712,-2
138,3,44,932,804,128
138,3,45,788,870,-82
138,3,46,784,783,1
138,3,47,759,727,32
138,3,48,791,775,16
138,3,49,789,543,246
138,3,50,1233,658,575
138,3,51,818,733,85
138,3,52,753,608,145
138,3,53,794,796,-2
138,3,54,789,701,88
138,3,55,636,723,-87
138,3,56,856,679,177
138,3,57,1018,792,226
138,3,58,713,658,55
138,3,59,725,518,207
138,3,60,742,743,-1
138,3,62,752,881,-129
138,3,63,836,700,136
138,3,64,730,732,-2
138,3,65,929,570,359
138,3,66,833,730,103
138,3,68,866,852,14
138,3,69,676,668,8
138,3,70,865,667,198
138,3,71,807,737,70
138,3,72,690,828,-138
139,1,1,1333,1576,-243
139,1,2,1400,1631,-231
139,1,4,1512,1536,-24
139,1,5,1396,1453,-57
139,1,6,1401,1478,-77
139,1,7,1353,1370,-17
139,1,8,1899,1459,440
139,1,9,1503,1591,-88
139,1,10,1347,1581,-234
139,1,11,1460,1533,-73
139,1,13,1378,1567,-189
139,1,14,1797,1656,141
139,1,15,1498,1527,-29
139,1,18,1319,1815,-496
139,1,19,1394,1302,92
139,1,21,1721,1076,645
139,1,22,1301,708,593
139,1,23,1396,1015,381
139,1,25,1365,867,498
139,1,26,1308,985,323
139,1,28,1452,1206,246
139,1,29,1456,1422,34
139,1,30,1416,1499,-83
139,1,31,1383,1220,163
139,1,32,1455,1500,-45
139,1,34,1648,1301,347
139,1,35,1618,1353,265
139,1,36,1538,1141,397
139,1,37,1496,1079,417
139,1,38,1641,1261,380
139,1,39,1337,1586,-249
139,1,40,1412,1292,120
139,1,41,1362,1407,-45
139,1,42,1416,1293,123
139,1,44,1593,1512,81
139,1,45,1410,1496,-86
139,1,46,1437,1322,115
139,1,47,1357,972,385
139,1,48,1377,1638,-261
139,1,49,1360,1315,45
139,1,50,1348,1398,-50
139,1,51,1349,1173,176
139,1,53,1429,1493,-64
139,1,54,1335,1410,-75
139,1,55,1331,1663,-332
139,1,58,1312,1189,123
139,1,59,1288,1322,-34
139,1,60,1386,1273,113
139,1,61,1487,1390,97
139,1,62,1386,1386,0
139,1,63,1690,1116,574
139,1,64,1498,1503,-5
139,1,65,1452,1319,133
139,1,66,1313,1331,-18
139,1,67,1392,1403,-11
139,1,68,1340,1243,97
139,1,69,1505,1309,196
139,1,70,1323,1162,161
139,1,71,1329,1321,8
139,1,72,1368,1283,85
140,2,1,1033,1689,-656
140,2,2,901,1099,-198
140,2,3,856,984,-128
140,2,4,972,1069,-97
140,2,5,897,997,-100
140,2,6,880,976,-96
140,2,8,1111,959,152
140,2,9,894,1857,-963
140,2,10,866,823,43
140,2,11,1119,965,154
140,2,12,861,878,-17
140,2,13,892,792,100
140,2,14,890,1033,-143
140,2,15,949,1132,-183
140,2,16,941,889,52
140,2,17,1126,863,263
140,2,18,840,990,-150
140,2,19,829,1198,-369
140,2,20,877,997,-120
140,2,21,892,1246,-354
140,2,22,960,1106,-146
140,2,23,851,911,-60
140,2,24,972,979,-7
140,2,26,969,1079,-110
140,2,27,831,944,-113
140,2,28,839,961,-122
140,2,29,818,938,-120
140,2,31,885,951,-66
140,2,32,861,861,0
140,2,33,811,738,73
140,2,34,886,1151,-265
140,2,35,854,594,260
140,2,36,932,997,-65
140,2,37,970,1054,-84
140,2,38,941,528,413
140,2,39,555,469,86
140,2,40,979,423,556
140,2,41,895,501,394
140,2,42,883,1017,-134
140,2,43,774,274,500
140,2,44,863,851,12
140,2,45,903,606,297
140,2,46,804,700,104
140,2,47,943,1173,-230
140,2,48,1058,440,618
140,2,50,680,357,323
140,2,51,854,236,618
140,2,52,1062,934,128
140,2,53,929,559,370
140,2,54,513,474,39
140,2,55,698,339,359
140,2,56,568,249,319
140,2,57,776,427,349
140,2,58,937,1162,-225
140,2,60,892,536,356
140,2,61,1268,782,486
140,2,63,940,715,225
140,2,64,447,235,212
140,2,65,1142,891,251
140,2,66,831,440,391
140,2,67,850,375,475
140,2,68,691,88,603
140,2,69,889,130,759
140,2,70,536,386,150
140,2,71,864,264,600
140,2,72,554,669,-115
141,3,1,851,1059,-208
141,3,3,795,780,15
141,3,5,737,789,-52
141,3,8,780,790,-10
141,3,10,726,790,-64
141,3,12,716,756,-40
141,3,13,729,641,88
141,3,14,767,763,4
141,3,15,759,1049,-290
141,3,16,700,762,-62
141,3,17,706,815,-109
141,3,18,750,728,22
141,3,19,957,847,110
141,3,20,779,705,74
141,3,21,717,742,-25
141,3,22,744,679,65
141,3,23,656,699,-43
141,3,25,624,751,-127
141,3,26,728,669,59
141,3,27,764,745,19
141,3,28,778,769,9
141,3,29,704,691,13
141,3,30,642,719,-77
141,3,31,793,654,139
141,3,32,820,729,91
141,3,33,690,754,-64
141,3,34,851,710,141
141,3,35,862,538,324
141,3,36,764,842,-78
141,3,38,688,601,87
141,3,39,729,1244,-515
141,3,41,641,701,-60
141,3,42,819,728,91
141,3,43,714,554,160
141,3,44,654,641,13
141,3,45,770,718,52
141,3,46,686,712,-26
141,3,47,959,1014,-55
141,3,48,1199,1017,182
141,3,49,703,716,-13
141,3,50,700,708,-8
141,3,52,957,649,308
141,3,53,709,630,79
141,3,54,672,631,41
141,3,55,1484,675,809
141,3,56,843,686,157
141,3,57,940,801,139
141,3,59,731,626,105
141,3,60,709,738,-29
141,3,61,851,594,257
141,3,62,759,681,78
141,3,63,720,649,71
141,3,64,738,808,-70
141,3,65,728,676,52
141,3,66,787,988,-201
141,3,67,649,658,-9
141,3,68,733,1079,-346
141,3,69,711,677,34
141,3,70,949,804,145
141,3,71,1062,771,291
142,2,1,839,977,-138
142,2,2,889,950,-61
142,2,3,925,776,149
142,2,4,855,842,13
142,2,5,682,771,-89
142,2,6,886,631,255
142,2,7,849,1084,-235
142,2,8,720,761,-41
142,2,9,683,714,-31
142,2,10,700,676,24
142,2,11,757,682,75
142,2,12,771,633,138
142,2,13,788,682,106
142,2,14,676,658,18
142,2,15,724,685,39
142,2,16,1039,602,437
142,2,17,750,616,134
142,2,18,641,620,21
142,2,19,1029,699,330
142,2,20,709,676,33
142,2,21,665,564,101
142,2,22,704,610,94
142,2,23,633,685,-52
142,2,24,699,719,-20
142,2,25,715,595,120
142,2,26,727,580,147
142,2,27,636,615,21
142,2,28,679,678,1
142,2,29,709,576,133
142,2,30,755,629,126
142,2,31,691,618,73
142,2,33,727,568,159
142,2,34,712,544,168
142,2,35,660,614,46
142,2,36,826,653,173
142,2,37,732,525,207
142,2,38,728,679,49
142,2,39,736,666,70
142,2,40,686,608,78
142,2,41,638,587,51
142,2,43,643,622,21
142,2,44,714,581,133
142,2,45,638,607,31
142,2,46,688,623,65
142,2,47,696,556,140
142,2,48,658,549,109
142,2,49,588,565,23
142,2,50,687,722,-35
142,2,51,644,540,104
142,2,52,685,624,61
142,2,53,650,575,75
142,2,54,653,619,34
142,2,55,671,585,86
142,2,56,658,553,105
142,2,57,650,579,71
142,2,58,667,646,21
142,2,59,712,580,132
142,2,60,719,632,87
142,2,61,740,593,147
142,2,62,677,579,98
142,2,63,717,594,123
142,2,64,700,536,164
142,2,66,683,607,76
142,2,67,599,587,12
142,2,68,1226,564,662
142,2,69,683,671,12
142,2,70,629,589,40
142,2,71,697,670,27
142,2,72,737,704,33
143,1,1,1083,1194,-111
143,1,2,1201,1120,81
143,1,3,1002,1212,-210
143,1,4,1101,1055,46
143,1,5,1024,1024,0
143,1,6,1173,955,218
143,1,8,1151,1298,-147
143,1,9,1118,881,237
143,1,10,1029,1042,-13
143,1,11,969,985,-16
143,1,12,1417,1091,326
143,1,13,885,930,-45
143,1,14,844,993,-149
143,1,15,869,847,22
143,1,16,1007,1010,-3
143,1,17,896,575,321
143,1,18,998,751,247
143,1,19,1064,751,313
143,1,20,1046,967,79
143,1,21,1066,646,420
143,1,22,1204,455,749
143,1,23,939,524,415
143,1,24,1222,1141,81
143,1,25,874,765,109
143,1,26,1193,1162,31
143,1,27,1022,976,46
143,1,28,1127,1175,-48
143,1,29,942,460,482
143,1,30,1040,855,185
143,1,32,849,893,-44
143,1,34,927,751,176
143,1,35,1195,857,338
143,1,40,986,931,55
143,1,41,1019,1061,-42
143,1,42,956,1067,-111
143,1,43,1078,947,131
143,1,44,818,884,-66
143,1,45,815,702,113
143,1,48,952,886,66
143,1,49,867,637,230
143,1,52,809,972,-163
143,1,53,1208,1044,164
143,1,55,1014,815,199
143,1,56,849,756,93
143,1,57,1090,858,232
143,1,58,1003,820,183
143,1,59,852,948,-96
143,1,60,947,422,525
143,1,61,919,577,342
143,1,63,811,502,309
143,1,64,875,584,291
143,1,65,942,862,80
143,1,66,842,615,227
143,1,67,739,692,47
143,1,68,1006,957,49
143,1,69,1196,837,359
143,1,70,1022,849,173
143,1,71,827,738,89
144,2,2,872,1032,-160
144,2,3,976,952,24
144,2,4,928,1056,-128
144,2,5,896,908,-12
144,2,6,892,1116,-224
144,2,7,988,836,152
144,2,8,820,832,-12
144,2,9,864,796,68
144,2,10,1080,692,388
144,2,11,868,788,80
144,2,12,892,600,292
144,2,13,1848,788,1060
144,2,14,1332,964,368
144,2,15,828,400,428
144,2,16,804,363,441
144,2,17,812,412,400
144,2,18,808,156,652
144,2,19,772,368,404
144,2,20,676,404,272
144,2,21,996,444,552
144,2,22,840,852,-12
144,2,23,900,860,40
144,2,24,804,320,484
144,2,26,848,92,756
144,2,27,912,368,544
144,2,28,800,36,764
144,2,29,776,388,388
144,2,30,764,108,656
144,2,31,740,436,304
144,2,32,772,4,768
144,2,33,732,384,348
144,2,34,836,276,560
144,2,36,780,288,492
144,2,37,736,695,41
144,2,38,750,352,398
144,2,40,728,300,428
144,2,41,824,332,492
144,2,42,836,248,588
144,2,43,796,810,-14
144,2,44,780,364,416
144,2,45,684,16,668
144,2,46,745,296,449
144,2,47,584,212,372
144,2,48,744,184,560
144,2,49,768,380,388
144,2,50,724,20,704
144,2,51,724,500,224
144,2,52,968,364,604
144,2,53,763,292,471
144,2,54,600,428,172
144,2,55,724,240,484
144,2,57,756,148,608
144,2,58,756,272,484
144,2,59,840,156,684
144,2,60,764,444,320
144,2,61,796,468,328
144,2,62,624,216,408
144,2,63,784,300,484
144,2,64,636,280,356
144,2,65,787,156,631
144,2,67,636,60,576
144,2,68,748,736,12
144,2,69,720,152,568
144,2,70,776,16,760
144,2,71,736,256,480
144,2,72,714,260,454
145,2,1,1010,1651,-641
145,2,2,934,1385,-451
145,2,3,1011,1131,-120
145,2,4,931,1351,-420
145,2,5,1114,1276,-162
145,2,6,1271,1171,100
145,2,7,1004,1283,-279
145,2,8,1058,1185,-127
145,2,9,1025,1168,-143
145,2,10,1164,1418,-254
145,2,11,1000,1353,-353
145,2,12,970,1465,-495
145,2,13,987,1165,-178
145,2,14,924,1073,-149
145,2,15,1231,1150,81
145,2,16,917,1131,-214
145,2,17,917,1191,-274
145,2,18,1060,1085,-25
145,2,19,1157,1136,21
145,2,20,964,988,-24
145,2,21,1045,1059,-14
145,2,22,975,1053,-78
145,2,23,1126,1000,126
145,2,24,1043,1112,-69
145,2,25,1158,943,215
145,2,26,992,972,20
145,2,27,927,1058,-131
145,2,28,947,1012,-65
145,2,29,1031,969,62
145,2,30,979,1098,-119
145,2,31,1019,932,87
145,2,32,1054,1173,-119
145,2,33,1041,1178,-137
145,2,34,1129,956,173
145,2,35,971,1079,-108
145,2,36,1006,1029,-23
145,2,37,898,1076,-178
145,2,38,1003,867,136
145,2,39,1101,988,113
145,2,40,929,1259,-330
145,2,41,1047,1265,-218
145,2,42,1039,1030,9
145,2,43,959,938,21
145,2,44,1081,989,92
145,2,45,1084,990,94
145,2,46,961,1164,-203
145,2,47,1122,1136,-14
145,2,48,1079,1207,-128
145,2,49,1348,1094,254
145,2,50,1146,1154,-8
145,2,51,1054,1222,-168
145,2,52,1085,1273,-188
145,2,53,1109,1058,51
145,2,54,995,1244,-249
145,2,55,964,1079,-115
145,2,56,1095,1023,72
145,2,57,947,969,-22
145,2,58,1076,1050,26
145,2,59,1029,1073,-44
145,2,60,917,1246,-329
145,2,61,920,1065,-145
145,2,62,920,1229,-309
145,2,63,905,1015,-110
145,2,64,927,985,-58
145,2,65,886,857,29
145,2,66,925,1097,-172
145,2,67,947,976,-29
145,2,68,957,975,-18
145,2,69,899,1051,-152
145,2,70,888,990,-102
145,2,71,960,1150,-190
145,2,72,968,991,-23
146,1,1,772,879,-107
146,1,2,875,760,115
146,1,3,787,737,50
146,1,4,813,651,162
146,1,5,840,724,116
146,1,6,810,694,116
146,1,7,720,654,66
146,1,8,802,656,146
146,1,9,801,700,101
146,1,10,817,925,-108
146,1,11,668,746,-78
146,1,12,791,804,-13
146,1,13,819,768,51
146,1,15,792,708,84
146,1,16,740,737,3
146,1,18,757,722,35
146,1,19,828,731,97
146,1,20,791,724,67
146,1,21,815,701,114
146,1,22,936,710,226
146,1,23,769,993,-224
146,1,24,762,678,84
146,1,25,727,1011,-284
146,1,26,908,1274,-366
146,1,27,973,764,209
146,1,28,731,681,50
146,1,29,826,744,82
146,1,30,842,760,82
146,1,31,808,742,66
146,1,32,802,801,1
146,1,33,1037,796,241
146,1,34,822,821,1
146,1,35,814,681,133
146,1,36,701,666,35
146,1,37,761,675,86
146,1,38,882,800,82
146,1,39,761,676,85
146,1,40,791,744,47
146,1,41,686,731,-45
146,1,42,796,717,79
146,1,43,682,696,-14
146,1,44,783,746,37
146,1,45,727,789,-62
146,1,46,795,680,115
146,1,47,770,766,4
146,1,48,700,729,-29
146,1,49,767,700,67
146,1,50,1112,1061,51
146,1,51,816,796,20
146,1,52,803,749,54
146,1,53,1318,1219,99
146,1,54,778,855,-77
146,1,55,754,767,-13
146,1,56,813,699,114
146,1,58,877,694,183
146,1,59,734,684,50
146,1,60,724,850,-126
146,1,61,835,833,2
146,1,62,745,1110,-365
146,1,63,1048,1157,-109
146,1,64,1229,1130,99
146,1,65,1110,1251,-141
146,1,67,849,1099,-250
146,1,68,770,654,116
146,1,69,784,657,127
146,1,70,715,710,5
146,1,71,828,921,-93
146,1,72,815,670,145
147,2,1,986,1356,-370
147,2,2,984,1064,-80
147,2,3,1042,1206,-164
147,2,4,994,1148,-154
147,2,5,921,979,-58
147,2,6,863,1104,-241
147,2,7,849,940,-91
147,2,8,891,924,-33
147,2,9,842,1148,-306
147,2,10,897,1052,-155
147,2,11,885,840,45
147,2,12,899,1206,-307
147,2,13,1126,938,188
147,2,14,882,972,-90
147,2,15,909,967,-58
147,2,16,948,887,61
147,2,17,979,988,-9
147,2,18,872,946,-74
147,2,19,827,1044,-217
147,2,20,889,1036,-147
147,2,21,911,1011,-100
147,2,22,926,1283,-357
147,2,23,1016,955,61
147,2,24,840,1218,-378
147,2,25,879,1057,-178
147,2,26,798,942,-144
147,2,27,907,941,-34
147,2,28,922,969,-47
147,2,29,902,906,-4
147,2,30,818,963,-145
147,2,31,887,860,27
147,2,32,935,970,-35
147,2,33,809,1058,-249
147,2,34,907,822,85
147,2,35,882,851,31
147,2,36,925,1093,-168
147,2,37,956,934,22
147,2,38,899,1165,-266
147,2,39,904,900,4
147,2,40,888,946,-58
147,2,41,825,980,-155
147,2,43,964,1095,-131
147,2,44,884,1006,-122
147,2,45,978,920,58
147,2,46,911,1072,-161
147,2,48,910,897,13
147,2,50,865,940,-75
147,2,51,1062,871,191
147,2,52,885,832,53
147,2,53,869,865,4
147,2,54,835,987,-152
147,2,55,858,982,-124
147,2,56,807,1065,-258
147,2,57,886,888,-2
147,2,58,857,1019,-162
147,2,59,1194,1100,94
147,2,60,881,876,5
147,2,61,833,1088,-255
147,2,62,854,1042,-188
147,2,63,888,1265,-377
147,2,64,792,786,6
147,2,65,777,971,-194
147,2,66,801,866,-65
147,2,67,1013,939,74
147,2,68,866,950,-84
147,2,69,837,841,-4
147,2,70,860,886,-26
147,2,71,935,890,45
147,2,72,872,1865,-993
148,2,1,924,835,89
148,2,2,869,860,9
148,2,3,963,1085,-122
148,2,4,946,789,157
148,2,5,946,786,160
148,2,6,746,826,-80
148,2,7,857,695,162
148,2,8,736,1032,-296
148,2,9,806,726,80
148,2,10,909,823,86
148,2,12,1149,813,336
148,2,13,986,980,6
148,2,14,869,828,41
148,2,15,854,925,-71
148,2,16,947,998,-51
148,2,17,867,742,125
148,2,19,895,907,-12
148,2,20,923,912,11
148,2,21,932,914,18
148,2,23,1589,1080,509
148,2,24,1038,1401,-363
148,2,25,866,756,110
148,2,26,1083,705,378
148,2,27,1202,1098,104
148,2,28,1129,1074,55
148,2,29,1455,1212,243
148,2,31,942,987,-45
148,2,32,982,930,52
148,2,33,942,1008,-66
148,2,34,1027,785,242
148,2,35,1215,1035,180
148,2,36,1096,1050,46
148,2,38,760,750,10
148,2,39,772,996,-224
148,2,40,1242,1067,175
148,2,41,1193,1134,59
148,2,42,898,1175,-277
148,2,43,995,681,314
148,2,44,1269,878,391
148,2,45,948,917,31
148,2,46,991,835,156
148,2,47,999,819,180
148,2,48,813,900,-87
148,2,49,838,735,103
148,2,50,987,1196,-209
148,2,51,960,1249,-289
148,2,52,991,874,117
148,2,53,933,895,38
148,2,54,987,1232,-245
148,2,55,888,1022,-134
148,2,56,936,732,204
148,2,57,1203,1213,-10
148,2,58,945,1054,-109
148,2,59,1019,1197,-178
148,2,60,911,1104,-193
148,2,61,1098,1217,-119
148,2,62,1189,1110,79
148,2,63,1626,1185,441
148,2,64,1152,1172,-20
148,2,65,1171,855,316
148,2,67,1241,1045,196
148,2,68,1241,1129,112
148,2,69,1063,1038,25
148,2,70,1195,1283,-88
148,2,71,1141,1149,-8
148,2,72,1070,1109,-39
149,3,1,1152,1436,-284
149,3,2,1078,1185,-107
149,3,3,1162,961,201
149,3,4,979,1160,-181
149,3,5,1032,1064,-32
149,3,6,1173,1178,-5
149,3,7,1066,876,190
149,3,8,1046,1184,-138
149,3,9,1119,1128,-9
149,3,10,1040,928,112
149,3,11,1014,1042,-28
149,3,12,1115,1046,69
149,3,13,1233,953,280
149,3,14,919,1047,-128
149,3,15,1057,987,70
149,3,16,904,893,11
149,3,17,897,905,-8
149,3,18,950,879,71
149,3,19,916,1159,-243
149,3,20,910,957,-47
149,3,21,881,953,-72
149,3,22,927,1014,-87
149,3,23,923,977,-54
149,3,24,912,1018,-106
149,3,25,949,748,201
149,3,26,1058,1011,47
149,3,27,830,960,-130
149,3,28,785,820,-35
149,3,29,910,793,117
149,3,30,974,848,126
149,3,31,938,974,-36
149,3,32,913,895,18
149,3,33,832,882,-50
149,3,34,891,828,63
149,3,35,823,965,-142
149,3,36,920,851,69
149,3,37,847,944,-97
149,3,38,829,812,17
149,3,39,879,997,-118
149,3,40,906,953,-47
149,3,41,904,855,49
149,3,42,960,1012,-52
149,3,43,929,941,-12
149,3,44,946,898,48
149,3,45,1005,887,118
149,3,46,878,974,-96
149,3,47,923,840,83
149,3,48,1224,834,390
149,3,49,934,905,29
149,3,50,800,904,-104
149,3,51,841,929,-88
149,3,52,904,842,62
149,3,53,971,1080,-109
149,3,54,823,932,-109
149,3,55,903,1075,-172
149,3,56,837,775,62
149,3,57,958,869,89
149,3,58,830,1162,-332
149,3,59,901,862,39
149,3,60,961,960,1
149,3,61,842,813,29
149,3,62,890,864,26
149,3,63,926,1009,-83
149,3,64,879,859,20
149,3,65,891,820,71
149,3,66,889,833,56
149,3,67,1174,1128,46
149,3,68,996,1280,-284
149,3,69,1274,1102,172
149,3,70,1124,1104,20
149,3,71,1237,1200,37
149,3,72,989,1302,-313
150,1,1,1224,1085,139
150,1,2,1072,964,108
150,1,3,950,993,-43
150,1,4,1228,1416,-188
150,1,5,1470,1122,348
150,1,6,1589,1017,572
150,1,8,1310,657,653
150,1,10,1382,849,533
150,1,11,1038,808,230
150,1,12,1332,853,479
150,1,13,608,354,254
150,1,15,699,516,183
150,1,16,331,249,82
150,1,20,712,515,197
150,1,21,1048,772,276
150,1,22,1033,787,246
150,1,23,1046,994,52
150,1,24,1075,814,261
150,1,25,1021,241,780
150,1,26,994,387,607
150,1,27,1042,933,109
150,1,28,1053,821,232
150,1,29,817,644,173
150,1,30,733,353,380
150,1,31,1166,352,814
150,1,32,1097,859,238
150,1,33,1057,555,502
150,1,34,872,386,486
150,1,35,1026,346,680
150,1,36,560,323,237
150,1,37,1028,474,554
150,1,38,933,329,604
150,1,39,909,464,445
150,1,40,801,548,253
150,1,41,839,475,364
150,1,42,819,744,75
150,1,43,876,293,583
150,1,44,1113,636,477
150,1,45,882,654,228
150,1,46,853,317,536
150,1,47,891,500,391
150,1,48,876,288,588
150,1,49,1098,434,664
150,1,50,932,351,581
150,1,51,862,506,356
150,1,52,855,387,468
150,1,53,967,578,389
150,1,55,832,323,509
150,1,56,718,498,220
150,1,58,897,429,468
150,1,59,771,389,382
150,1,60,820,478,342
150,1,61,925,1640,-715
150,1,62,1786,1765,21
150,1,63,1689,1676,13
150,1,64,1669,1725,-56
150,1,65,1707,1655,52
150,1,66,1712,1778,-66
150,1,67,1672,1705,-33
150,1,68,1730,1893,-163
150,1,69,1816,1881,-65
150,1,70,1827,1726,101
150,1,71,1711,1774,-63
150,1,72,980,794,186
151,3,1,986,1581,-595
151,3,2,808,1364,-556
151,3,3,812,1519,-707
151,3,4,760,1313,-553
151,3,5,762,1209,-447
151,3,6,919,1225,-306
151,3,7,973,1055,-82
151,3,9,976,984,-8
151,3,10,861,980,-119
151,3,11,857,1065,-208
151,3,12,893,1190,-297
151,3,13,1116,1045,71
151,3,14,749,974,-225
151,3,15,695,928,-233
151,3,16,817,1179,-362
151,3,17,833,1026,-193
151,3,18,841,1067,-226
151,3,19,718,984,-266
151,3,20,976,1288,-312
151,3,21,717,1312,-595
151,3,22,1165,1022,143
151,3,23,715,700,15
151,3,24,782,1104,-322
151,3,26,867,1061,-194
151,3,27,720,993,-273
151,3,28,748,1175,-427
151,3,29,845,1079,-234
151,3,30,863,960,-97
151,3,32,897,1396,-499
151,3,33,969,1117,-148
151,3,34,1120,1122,-2
151,3,36,737,907,-170
151,3,37,761,1050,-289
151,3,38,754,876,-122
151,3,39,826,1116,-290
151,3,40,764,958,-194
151,3,42,677,934,-257
151,3,43,835,1183,-348
151,3,44,721,909,-188
151,3,45,779,942,-163
151,3,46,810,1020,-210
151,3,47,671,936,-265
151,3,48,733,1006,-273
151,3,49,852,903,-51
151,3,50,859,957,-98
151,3,51,836,855,-19
151,3,52,768,936,-168
151,3,55,685,959,-274
151,3,56,898,957,-59
151,3,57,805,1006,-201
151,3,58,1235,918,317
151,3,59,848,977,-129
151,3,61,843,991,-148
151,3,62,837,967,-130
151,3,63,753,1020,-267
151,3,64,721,947,-226
151,3,65,703,849,-146
151,3,66,888,1002,-114
151,3,67,967,1274,-307
151,3,68,698,837,-139
151,3,70,774,825,-51
151,3,71,799,994,-195
151,3,72,724,1047,-323
152,1,1,861,1318,-457
152,1,2,882,1070,-188
152,1,3,922,1052,-130
152,1,4,1004,970,34
152,1,5,965,1044,-79
152,1,6,894,862,32
152,1,7,932,958,-26
152,1,8,1178,965,213
152,1,9,784,891,-107
152,1,10,887,911,-24
152,1,11,809,871,-62
152,1,12,852,978,-126
152,1,13,996,873,123
152,1,14,1022,1048,-26
152,1,15,927,552,375
152,1,16,942,584,358
152,1,17,826,506,320
152,1,18,827,532,295
152,1,19,940,467,473
152,1,20,889,435,454
152,1,21,841,526,315
152,1,22,854,420,434
152,1,23,511,505,6
152,1,24,958,629,329
152,1,26,810,700,110
152,1,27,1155,612,543
152,1,29,908,594,314
152,1,30,956,411,545
152,1,31,1050,830,220
152,1,32,918,431,487
152,1,33,803,354,449
152,1,34,808,802,6
152,1,35,815,461,354
152,1,36,874,432,442
152,1,37,842,547,295
152,1,38,1002,437,565
152,1,39,959,839,120
152,1,40,995,886,109
152,1,41,772,865,-93
152,1,42,845,277,568
152,1,43,931,478,453
152,1,44,849,475,374
152,1,45,834,607,227
152,1,46,868,664,204
152,1,47,919,780,139
152,1,48,835,491,344
152,1,49,1012,828,184
152,1,51,1174,526,648
152,1,52,1319,613,706
152,1,53,940,375,565
152,1,54,813,354,459
152,1,55,863,970,-107
152,1,56,754,784,-30
152,1,57,1197,400,797
152,1,58,1129,784,345
152,1,59,894,420,474
152,1,60,808,280,528
152,1,61,712,428,284
152,1,62,736,374,362
152,1,63,746,555,191
152,1,64,803,300,503
152,1,65,792,413,379
152,1,66,744,335,409
152,1,67,802,287,515
152,1,68,879,811,68
152,1,69,830,443,387
152,1,71,781,398,383
152,1,72,826,453,373
153,3,1,1155,1357,-202
153,3,2,1225,1228,-3
153,3,3,972,1124,-152
153,3,4,1204,1130,74
153,3,5,1155,1104,51
153,3,6,1043,1588,-545
153,3,7,1591,1255,336
153,3,8,1121,1105,16
153,3,9,1002,1058,-56
153,3,10,928,1067,-139
153,3,11,1258,1188,70
153,3,12,1454,1358,96
153,3,13,1098,1056,42
153,3,14,1128,1081,47
153,3,15,1052,972,80
153,3,16,1258,890,368
153,3,18,1006,1279,-273
153,3,19,1216,1208,8
153,3,20,1362,1153,209
153,3,21,1251,1073,178
153,3,22,1068,1220,-152
153,3,23,1193,1195,-2
153,3,24,1088,1178,-90
153,3,25,1005,1157,-152
153,3,26,979,1347,-368
153,3,27,1032,1538,-506
153,3,28,1096,1065,31
153,3,29,960,967,-7
153,3,30,1012,1012,0
153,3,31,1131,1051,80
153,3,33,1057,1083,-26
153,3,34,1128,1187,-59
153,3,35,1048,1103,-55
153,3,36,1023,1424,-401
153,3,37,1098,993,105
153,3,38,1203,1404,-201
153,3,39,1105,962,143
153,3,40,1553,1088,465
153,3,41,1023,1088,-65
153,3,42,1130,1138,-8
153,3,43,1252,1140,112
153,3,44,1324,990,334
153,3,45,1282,1030,252
153,3,46,1387,1426,-39
153,3,47,1038,1240,-202
153,3,48,1017,1763,-746
153,3,49,989,1246,-257
153,3,50,1096,1089,7
153,3,51,1155,1059,96
153,3,52,1845,1123,722
153,3,53,1373,1141,232
153,3,54,1446,1095,351
153,3,55,976,1041,-65
153,3,56,1039,1075,-36
153,3,57,1022,1064,-42
153,3,58,973,1096,-123
153,3,59,1119,1014,105
153,3,60,1063,1135,-72
153,3,61,948,1180,-232
153,3,62,1076,1131,-55
153,3,63,1395,1153,242
153,3,64,1065,1169,-104
153,3,65,1126,1870,-744
153,3,66,1001,1032,-31
153,3,67,1081,1155,-74
153,3,68,1142,1376,-234
153,3,69,968,1080,-112
153,3,70,985,1125,-140
153,3,71,1113,1050,63
153,3,72,963,1004,-41
154,2,1,994,1160,-166
154,2,2,766,1200,-434
154,2,3,877,1026,-149
154,2,4,864,1037,-173
154,2,5,796,1171,-375
154,2,7,790,511,279
154,2,8,859,964,-105
154,2,9,699,709,-10
154,2,10,818,1146,-328
154,2,11,581,674,-93
154,2,12,809,909,-100
154,2,13,853,1150,-297
154,2,14,730,921,-191
154,2,15,555,1018,-463
154,2,16,847,1057,-210
154,2,17,842,939,-97
154,2,18,811,1040,-229
154,2,19,784,1109,-325
154,2,20,772,1068,-296
154,2,21,873,972,-99
154,2,22,822,1103,-281
154,2,23,721,1280,-559
154,2,24,892,906,-14
154,2,25,830,914,-84
154,2,26,868,900,-32
154,2,27,997,1158,-161
154,2,28,773,1113,-340
154,2,29,638,866,-228
154,2,30,886,984,-98
154,2,31,643,915,-272
154,2,32,727,937,-210
154,2,33,1030,1013,17
154,2,34,813,948,-135
154,2,35,786,871,-85
154,2,36,1054,1149,-95
154,2,37,801,1029,-228
154,2,38,413,801,-388
154,2,39,748,1004,-256
154,2,40,848,1051,-203
154,2,41,890,1070,-180
154,2,42,735,644,91
154,2,43,910,1006,-96
154,2,44,830,1309,-479
154,2,45,927,1033,-106
154,2,46,774,1303,-529
154,2,47,1413,1102,311
154,2,48,882,1277,-395
154,2,49,1140,902,238
154,2,50,823,1112,-289
154,2,51,998,936,62
154,2,52,684,912,-228
154,2,53,996,1005,-9
154,2,54,824,923,-99
154,2,55,779,972,-193
154,2,56,638,797,-159
154,2,57,1000,957,43
154,2,58,866,1152,-286
154,2,59,742,941,-199
154,2,60,852,829,23
154,2,61,723,861,-138
154,2,62,799,755,44
154,2,63,602,964,-362
154,2,64,905,692,213
154,2,65,1022,1146,-124
154,2,66,878,1092,-214
154,2,67,836,988,-152
154,2,68,850,994,-144
154,2,69,866,980,-114
154,2,70,950,993,-43
154,2,71,837,1060,-223
154,2,72,898,1190,-292
155,2,1,1645,1317,328
155,2,2,928,838,90
155,2,3,923,773,150
155,2,4,845,790,55
155,2,5,783,762,21
155,2,6,917,727,190
155,2,7,1190,753,437
155,2,8,780,870,-90
155,2,9,930,829,101
155,2,10,858,763,95
155,2,11,813,760,53
155,2,12,891,677,214
155,2,13,892,721,171
155,2,14,740,771,-31
155,2,15,798,663,135
155,2,16,780,694,86
155,2,17,904,740,164
155,2,18,766,696,70
155,2,19,836,750,86
155,2,20,921,780,141
155,2,21,910,785,125
155,2,22,723,726,-3
155,2,23,1081,708,373
155,2,24,844,806,38
155,2,25,724,670,54
155,2,26,723,717,6
155,2,27,827,690,137
155,2,28,845,703,142
155,2,29,851,690,161
155,2,30,852,685,167
155,2,31,825,661,164
155,2,32,772,759,13
155,2,33,866,652,214
155,2,34,910,744,166
155,2,35,845,784,61
155,2,36,787,772,15
155,2,38,851,661,190
155,2,39,769,772,-3
155,2,40,777,684,93
155,2,41,816,723,93
155,2,42,768,729,39
155,2,43,806,793,13
155,2,44,782,762,20
155,2,45,726,695,31
155,2,46,771,735,36
155,2,47,755,780,-25
155,2,48,867,700,167
155,2,49,933,711,222
155,2,50,692,646,46
155,2,51,815,666,149
155,2,52,808,617,191
155,2,53,790,782,8
155,2,54,804,687,117
155,2,55,820,758,62
155,2,56,811,644,167
155,2,57,796,624,172
155,2,58,755,757,-2
155,2,60,881,828,53
155,2,61,759,722,37
155,2,63,734,737,-3
155,2,64,745,810,-65
155,2,65,775,674,101
155,2,66,806,656,150
155,2,67,852,688,164
155,2,68,756,766,-10
155,2,69,794,757,37
155,2,70,689,644,45
155,2,71,954,749,205
155,2,72,819,765,54
156,2,1,972,1302,-330
156,2,2,1604,1158,446
156,2,3,945,1096,-151
156,2,4,1012,1016,-4
156,2,5,909,1102,-193
156,2,6,939,1093,-154
156,2,7,888,993,-105
156,2,8,966,1093,-127
156,2,9,818,1033,-215
156,2,10,866,1166,-300
156,2,11,1162,1084,78
156,2,12,989,959,30
156,2,13,969,1050,-81
156,2,14,900,1092,-192
156,2,15,836,1166,-330
156,2,16,641,1020,-379
156,2,17,837,1042,-205
156,2,18,682,923,-241
156,2,19,899,1018,-119
156,2,20,786,1080,-294
156,2,21,784,755,29
156,2,22,751,1094,-343
156,2,25,1063,1638,-575
156,2,26,1066,1244,-178
156,2,27,953,1309,-356
156,2,28,1031,1184,-153
156,2,29,1010,1545,-535
156,2,30,978,1349,-371
156,2,31,1071,1392,-321
156,2,32,967,1108,-141
156,2,33,954,1220,-266
156,2,34,927,1225,-298
156,2,35,1072,1137,-65
156,2,36,1943,627,1316
156,2,37,1113,448,665
156,2,38,924,331,593
156,2,39,1127,569,558
156,2,40,873,809,64
156,2,41,988,898,90
156,2,42,940,670,270
156,2,43,861,403,458
156,2,44,889,395,494
156,2,45,852,1056,-204
156,2,46,965,344,621
156,2,47,990,549,441
156,2,48,1020,896,124
156,2,49,1030,339,691
156,2,50,944,950,-6
156,2,51,1110,891,219
156,2,52,910,343,567
156,2,53,937,1004,-67
156,2,54,1059,843,216
156,2,55,922,572,350
156,2,56,913,643,270
156,2,57,1170,1211,-41
156,2,58,937,1131,-194
156,2,59,839,376,463
156,2,60,1783,428,1355
156,2,61,998,1138,-140
156,2,62,831,280,551
156,2,63,942,265,677
156,2,64,828,916,-88
156,2,65,815,1224,-409
156,2,66,653,262,391
156,2,67,911,841,70
156,2,68,1051,70,981
156,2,69,722,795,-73
156,2,70,917,790,127
156,2,71,686,200,486
156,2,72,991,950,41
157,1,1,1246,1321,-75
157,1,2,891,1066,-175
157,1,3,975,918,57
157,1,4,902,903,-1
157,1,5,1642,711,931
157,1,6,811,691,120
157,1,7,944,701,243
157,1,8,820,720,100
157,1,9,814,596,218
157,1,10,917,599,318
157,1,11,822,676,146
157,1,12,1312,661,651
157,1,13,924,798,126
157,1,14,941,390,551
157,1,15,968,399,569
157,1,16,880,430,450
157,1,17,763,301,462
157,1,18,785,284,501
157,1,19,710,320,390
157,1,20,709,323,386
157,1,21,722,329,393
157,1,22,720,356,364
157,1,23,1043,403,640
157,1,24,655,379,276
157,1,25,918,292,626
157,1,26,867,260,607
157,1,27,744,299,445
157,1,28,799,357,442
157,1,29,883,204,679
157,1,30,563,331,232
157,1,31,838,359,479
157,1,32,749,447,302
157,1,33,781,403,378
157,1,34,677,349,328
157,1,35,679,231,448
157,1,36,743,404,339
157,1,37,789,269,520
157,1,38,864,449,415
157,1,39,690,312,378
157,1,40,753,424,329
157,1,41,799,346,453
157,1,42,785,469,316
157,1,43,802,459,343
157,1,44,817,665,152
157,1,45,828,682,146
157,1,46,867,546,321
157,1,47,901,678,223
157,1,48,775,250,525
157,1,49,545,429,116
157,1,50,731,487,244
157,1,51,760,149,611
157,1,52,734,328,406
157,1,53,785,350,435
157,1,54,716,450,266
157,1,55,723,617,106
157,1,56,697,414,283
157,1,57,575,293,282
157,1,58,614,346,268
157,1,60,640,287,353
157,1,61,1119,256,863
157,1,62,744,330,414
157,1,63,738,221,517
157,1,64,647,199,448
157,1,65,723,413,310
157,1,66,505,356,149
157,1,67,679,405,274
157,1,68,754,551,203
157,1,69,705,254,451
157,1,70,704,131,573
157,1,71,775,40,735
157,1,72,660,117,543
158,1,1,1011,1543,-532
158,1,2,930,1665,-735
158,1,3,872,1045,-173
158,1,4,923,1577,-654
158,1,5,828,894,-66
158,1,6,954,975,-21
158,1,8,856,1103,-247
158,1,9,925,933,-8
158,1,10,914,1075,-161
158,1,11,954,906,48
158,1,12,979,1036,-57
158,1,13,827,873,-46
158,1,15,835,1169,-334
158,1,16,911,1001,-90
158,1,18,904,941,-37
158,1,19,836,738,98
158,1,20,849,885,-36
158,1,21,903,876,27
158,1,22,945,1059,-114
158,1,24,861,880,-19
158,1,26,895,1085,-190
158,1,28,822,962,-140
158,1,30,1273,982,291
158,1,31,864,942,-78
158,1,32,1226,1085,141
158,1,33,924,1108,-184
158,1,34,801,884,-83
158,1,36,921,984,-63
158,1,37,1056,1209,-153
158,1,38,1274,1177,97
158,1,39,989,1110,-121
158,1,40,1098,1285,-187
158,1,41,1487,1619,-132
158,1,42,1187,1153,34
158,1,43,938,1070,-132
158,1,44,1263,1156,107
158,1,45,1177,1301,-124
158,1,46,1245,1220,25
158,1,47,1035,1171,-136
158,1,48,959,1057,-98
158,1,49,876,1151,-275
158,1,50,1135,1185,-50
158,1,51,982,969,13
158,1,52,760,840,-80
158,1,53,871,1018,-147
158,1,54,891,798,93
158,1,55,1019,1067,-48
158,1,56,924,935,-11
158,1,57,867,769,98
158,1,58,919,1050,-131
158,1,59,859,1200,-341
158,1,60,1000,1156,-156
158,1,61,1061,852,209
158,1,62,1266,1092,174
158,1,63,981,1274,-293
158,1,64,1005,1059,-54
158,1,66,1078,1015,63
158,1,67,968,961,7
158,1,68,1504,1236,268
158,1,69,872,1061,-189
158,1,70,853,1306,-453
158,1,71,954,830,124
158,1,72,1182,1189,-7
159,1,1,1253,1191,62
159,1,2,1110,1007,103
159,1,3,1114,967,147
159,1,4,973,1032,-59
159,1,5,1043,947,96
159,1,6,950,1058,-108
159,1,7,1097,989,108
159,1,8,1157,955,202
159,1,9,1008,1083,-75
159,1,10,988,1054,-66
159,1,11,1010,958,52
159,1,12,966,871,95
159,1,13,1043,798,245
159,1,15,964,916,48
159,1,16,952,764,188
159,1,17,1354,859,495
159,1,19,1074,889,185
159,1,20,1502,995,507
159,1,21,966,937,29
159,1,22,951,917,34
159,1,23,950,848,102
159,1,24,969,770,199
159,1,25,1646,945,701
159,1,27,814,982,-168
159,1,28,1123,864,259
159,1,29,933,1138,-205
159,1,30,877,665,212
159,1,31,934,818,116
159,1,32,944,815,129
159,1,33,866,847,19
159,1,34,763,960,-197
159,1,35,938,664,274
159,1,36,1346,665,681
159,1,37,1146,980,166
159,1,38,871,744,127
159,1,39,942,775,167
159,1,40,1193,831,362
159,1,41,872,737,135
159,1,42,947,986,-39
159,1,43,1035,759,276
159,1,44,1028,848,180
159,1,45,913,810,103
159,1,46,876,991,-115
159,1,47,930,815,115
159,1,48,1031,741,290
159,1,49,822,808,14
159,1,50,949,700,249
159,1,51,1056,734,322
159,1,52,861,828,33
159,1,53,910,847,63
159,1,54,977,643,334
159,1,55,869,868,1
159,1,56,743,780,-37
159,1,57,750,719,31
159,1,58,882,765,117
159,1,59,973,757,216
159,1,60,858,729,129
159,1,61,961,865,96
159,1,62,1057,755,302
159,1,63,745,811,-66
159,1,64,979,796,183
159,1,65,869,841,28
159,1,66,797,721,76
159,1,67,975,800,175
159,1,68,975,742,233
159,1,70,1000,794,206
159,1,71,821,620,201
159,1,72,1010,779,231
160,2,1,1027,988,39
160,2,2,1010,944,66
160,2,3,907,846,61
160,2,4,934,941,-7
160,2,5,942,856,86
160,2,6,939,820,119
160,2,7,969,1011,-42
160,2,8,950,705,245
160,2,9,952,790,162
160,2,10,796,700,96
160,2,11,888,885,3
160,2,12,902,815,87
160,2,13,1073,602,471
160,2,14,1367,778,589
160,2,15,1162,732,430
160,2,16,825,601,224
160,2,17,934,683,251
160,2,18,853,622,231
160,2,19,951,766,185
160,2,20,853,496,357
160,2,21,853,755,98
160,2,22,791,599,192
160,2,23,804,740,64
160,2,24,914,678,236
160,2,25,1051,809,242
160,2,26,886,861,25
160,2,27,868,741,127
160,2,29,893,686,207
160,2,30,823,769,54
160,2,31,888,835,53
160,2,32,844,711,133
160,2,33,899,810,89
160,2,34,796,688,108
160,2,35,996,923,73
160,2,36,854,781,73
160,2,37,1218,1048,170
160,2,38,1090,862,228
160,2,39,1023,986,37
160,2,40,1024,873,151
160,2,41,983,817,166
160,2,42,1222,778,444
160,2,43,1061,974,87
160,2,44,1035,881,154
160,2,45,1008,1024,-16
160,2,46,1173,978,195
160,2,47,1132,923,209
160,2,48,1014,931,83
160,2,49,977,1052,-75
160,2,50,1123,1328,-205
160,2,51,1339,689,650
160,2,52,833,746,87
160,2,53,855,722,133
160,2,54,915,805,110
160,2,55,844,743,101
160,2,56,811,844,-33
160,2,57,795,698,97
160,2,58,848,760,88
160,2,59,836,754,82
160,2,60,860,754,106
160,2,61,793,668,125
160,2,62,687,829,-142
160,2,63,803,708,95
160,2,64,885,862,23
160,2,65,913,779,134
160,2,66,965,724,241
160,2,67,728,600,128
160,2,68,800,847,-47
160,2,69,804,739,65
160,2,70,771,819,-48
160,2,71,882,674,208
160,2,72,880,951,-71
161,1,1,978,1473,-495
161,1,2,987,1381,-394
161,1,3,857,1092,-235
161,1,4,911,1235,-324
161,1,5,910,1102,-192
161,1,6,1018,1148,-130
161,1,7,1022,1087,-65
161,1,8,888,930,-42
161,1,9,1025,1437,-412
161,1,10,767,590,177
161,1,11,901,966,-65
161,1,12,1125,1043,82
161,1,13,943,930,13
161,1,14,922,1057,-135
161,1,15,1103,998,105
161,1,16,949,893,56
161,1,17,950,979,-29
161,1,18,957,923,34
161,1,19,847,966,-119
161,1,20,1015,954,61
161,1,21,890,865,25
161,1,22,908,927,-19
161,1,23,904,971,-67
161,1,24,976,1035,-59
161,1,25,925,856,69
161,1,26,931,841,90
161,1,27,1051,934,117
161,1,28,1067,927,140
161,1,29,884,921,-37
161,1,30,963,856,107
161,1,31,1031,1000,31
161,1,32,921,956,-35
161,1,33,899,923,-24
161,1,34,1016,861,155
161,1,35,1011,850,161
161,1,36,878,1085,-207
161,1,37,1162,982,180
161,1,38,880,816,64
161,1,39,1175,860,315
161,1,40,1036,911,125
161,1,41,821,834,-13
161,1,42,828,906,-78
161,1,43,885,856,29
161,1,44,850,864,-14
161,1,45,999,987,12
161,1,46,912,825,87
161,1,47,862,874,-12
161,1,48,910,951,-41
161,1,49,836,959,-123
161,1,50,924,914,10
161,1,51,866,958,-92
161,1,52,970,929,41
161,1,53,970,501,469
161,1,54,899,1036,-137
161,1,55,856,910,-54
161,1,56,1033,1025,8
161,1,57,1157,1220,-63
161,1,58,891,884,7
161,1,59,891,877,14
161,1,60,935,924,11
161,1,61,1056,778,278
161,1,62,551,348,203
161,1,63,892,859,33
161,1,64,748,354,394
161,1,65,912,990,-78
161,1,66,1022,970,52
161,1,67,852,868,-16
161,1,68,925,975,-50
161,1,69,1096,640,456
161,1,70,1029,942,87
161,1,71,925,762,163
161,1,72,837,871,-34
162,3,1,1019,1137,-118
162,3,2,1144,1080,64
162,3,3,1199,930,269
162,3,4,1099,885,214
162,3,5,1124,1048,76
162,3,6,994,934,60
162,3,8,1033,999,34
162,3,9,1253,1166,87
162,3,11,936,831,105
162,3,12,1063,928,135
162,3,13,1139,949,190
162,3,15,979,1697,-718
162,3,17,1011,1472,-461
162,3,18,1060,1145,-85
162,3,20,1041,856,185
162,3,21,1112,835,277
162,3,24,1032,955,77
162,3,25,1343,1987,-644
162,3,26,1513,874,639
162,3,27,962,1019,-57
162,3,29,1029,1086,-57
162,3,30,1237,1267,-30
162,3,31,1062,1567,-505
162,3,33,1194,1176,18
162,3,36,978,924,54
162,3,42,1702,888,814
162,3,43,945,1020,-75
162,3,48,993,864,129
162,3,49,1077,1189,-112
162,3,50,1207,1721,-514
162,3,52,1030,1119,-89
162,3,53,1056,1106,-50
162,3,54,1070,1053,17
162,3,55,1062,1639,-577
162,3,56,1185,1146,39
162,3,57,1248,1114,134
162,3,58,1103,1253,-150
162,3,59,1139,1149,-10
162,3,60,1110,1136,-26
162,3,61,1047,1210,-163
162,3,64,1266,1112,154
162,3,66,1174,1144,30
162,3,67,1549,1099,450
163,3,1,981,1481,-500
163,3,2,1006,1380,-374
163,3,3,1052,1246,-194
163,3,4,1068,1106,-38
163,3,5,1157,1145,12
163,3,6,993,1100,-107
163,3,7,1003,1068,-65
163,3,8,962,1032,-70
163,3,9,936,1122,-186
163,3,10,1047,1094,-47
163,3,11,1107,1035,72
163,3,12,894,1170,-276
163,3,13,897,951,-54
163,3,14,843,1138,-295
163,3,15,859,911,-52
163,3,16,843,916,-73
163,3,17,815,1208,-393
163,3,18,938,1039,-101
163,3,19,833,1164,-331
163,3,20,823,975,-152
163,3,21,789,1032,-243
163,3,22,948,1035,-87
163,3,23,864,1012,-148
163,3,24,893,1133,-240
163,3,25,828,1045,-217
163,3,26,749,1058,-309
163,3,27,863,979,-116
163,3,28,857,913,-56
163,3,29,781,1005,-224
163,3,30,824,793,31
163,3,31,851,911,-60
163,3,32,852,897,-45
163,3,33,735,681,54
163,3,34,833,914,-81
163,3,35,867,828,39
163,3,36,872,840,32
163,3,37,820,798,22
163,3,38,859,918,-59
163,3,39,830,853,-23
163,3,40,836,945,-109
163,3,41,780,980,-200
163,3,42,807,1444,-637
163,3,43,834,850,-16
163,3,44,853,732,121
163,3,46,783,810,-27
163,3,47,823,886,-63
163,3,48,842,1001,-159
163,3,49,816,1070,-254
163,3,50,823,801,22
163,3,52,703,784,-81
163,3,53,904,815,89
163,3,54,802,798,4
163,3,55,895,913,-18
163,3,56,828,667,161
163,3,57,835,777,58
163,3,58,862,958,-96
163,3,59,781,783,-2
163,3,60,820,841,-21
163,3,61,806,844,-38
163,3,62,875,880,-5
163,3,63,881,851,30
163,3,64,860,820,40
163,3,65,865,821,44
163,3,66,838,765,73
163,3,67,827,811,16
163,3,68,887,762,125
163,3,69,799,1021,-222
163,3,70,762,818,-56
163,3,71,853,759,94
163,3,72,768,929,-161
164,3,2,1085,1498,-413
164,3,3,1082,1202,-120
164,3,4,1067,1070,-3
164,3,5,1081,1048,33
164,3,6,1307,1194,113
164,3,7,1117,1223,-106
164,3,8,1082,1021,61
164,3,9,1195,1151,44
164,3,10,1195,1044,151
164,3,11,1220,1090,130
164,3,12,1114,1047,67
164,3,13,1112,1146,-34
164,3,14,1162,1124,38
164,3,15,1086,1094,-8
164,3,16,1095,1129,-34
164,3,17,1219,1064,155
164,3,18,1052,1526,-474
164,3,19,1081,1134,-53
164,3,20,1133,1166,-33
164,3,21,1082,1097,-15
164,3,22,1071,1082,-11
164,3,23,1152,1074,78
164,3,24,1119,1105,14
164,3,25,1097,1372,-275
164,3,26,1119,1288,-169
164,3,27,1066,1104,-38
164,3,28,1055,1054,1
164,3,29,1243,1491,-248
164,3,30,1063,1069,-6
164,3,31,1073,1046,27
164,3,32,1211,1077,134
164,3,33,1005,1026,-21
164,3,34,1049,1075,-26
164,3,35,1082,1118,-36
164,3,36,1064,1023,41
164,3,40,1047,1097,-50
164,3,41,998,1080,-82
164,3,42,1027,963,64
164,3,43,1135,1083,52
164,3,45,1255,1070,185
164,3,46,1172,1091,81
164,3,47,1081,1331,-250
164,3,48,1037,1029,8
164,3,49,1415,1272,143
164,3,50,1233,1177,56
164,3,51,1154,1079,75
164,3,52,1043,1163,-120
164,3,53,1253,1155,98
164,3,54,1145,1061,84
164,3,55,1040,1075,-35
164,3,56,1050,1072,-22
164,3,57,1060,1236,-176
164,3,58,1084,1103,-19
164,3,59,1085,1691,-606
164,3,60,1161,1055,106
164,3,61,1137,1092,45
164,3,62,1083,1117,-34
164,3,63,1051,1037,14
164,3,64,1104,1039,65
164,3,65,1060,1080,-20
164,3,66,1069,991,78
164,3,71,1145,1060,85
164,3,72,1233,1177,56
165,2,1,994,1164,-170
165,2,2,865,1160,-295
165,2,3,959,986,-27
165,2,4,1006,960,46
165,2,5,880,880,0
165,2,6,871,974,-103
165,2,7,909,757,152
165,2,8,928,1164,-236
165,2,9,891,1077,-186
165,2,10,1174,830,344
165,2,11,937,806,131
165,2,12,846,795,51
165,2,13,892,872,20
165,2,14,819,782,37
165,2,15,923,858,65
165,2,16,880,840,40
165,2,18,950,891,59
165,2,19,807,759,48
165,2,20,822,1079,-257
165,2,21,750,784,-34
165,2,22,882,733,149
165,2,24,836,726,110
165,2,25,781,811,-30
165,2,26,933,943,-10
165,2,27,789,551,238
165,2,28,822,693,129
165,2,29,789,878,-89
165,2,30,884,800,84
165,2,31,893,807,86
165,2,32,759,850,-91
165,2,33,790,707,83
165,2,34,776,965,-189
165,2,35,741,769,-28
165,2,36,878,756,122
165,2,37,780,817,-37
165,2,38,829,670,159
165,2,39,836,804,32
165,2,40,848,832,16
165,2,41,801,825,-24
165,2,42,893,804,89
165,2,43,807,1081,-274
165,2,44,785,689,96
165,2,45,825,767,58
165,2,46,832,833,-1
165,2,47,859,714,145
165,2,48,858,743,115
165,2,49,940,759,181
165,2,50,778,754,24
165,2,52,1070,858,212
165,2,53,737,749,-12
165,2,54,770,710,60
165,2,55,751,854,-103
165,2,56,818,804,14
165,2,57,777,965,-188
165,2,58,791,753,38
165,2,59,753,780,-27
165,2,60,782,788,-6
165,2,61,804,733,71
165,2,62,735,665,70
165,2,63,763,701,62
165,2,64,777,866,-89
165,2,65,760,881,-121
165,2,66,757,816,-59
165,2,67,1127,783,344
165,2,68,788,783,5
165,2,69,765,892,-127
165,2,70,746,743,3
165,2,71,819,998,-179
165,2,72,869,800,69
166,1,1,967,1465,-498
166,1,2,845,1366,-521
166,1,3,964,1165,-201
166,1,4,1006,1015,-9
166,1,5,838,989,-151
166,1,6,1003,1163,-160
166,1,7,885,1008,-123
166,1,8,893,959,-66
166,1,9,1098,916,182
166,1,10,866,884,-18
166,1,11,1063,902,161
166,1,12,881,867,14
166,1,13,808,1129,-321
166,1,14,832,751,81
166,1,15,1153,1026,127
166,1,16,835,908,-73
166,1,17,800,1040,-240
166,1,18,930,883,47
166,1,21,957,903,54
166,1,22,794,891,-97
166,1,23,864,769,95
166,1,24,913,601,312
166,1,25,749,333,416
166,1,26,807,440,367
166,1,27,667,365,302
166,1,28,609,226,383
166,1,29,618,354,264
166,1,30,786,235,551
166,1,31,579,245,334
166,1,32,651,236,415
166,1,33,464,457,7
166,1,34,749,270,479
166,1,35,769,714,55
166,1,36,782,327,455
166,1,37,732,397,335
166,1,38,712,417,295
166,1,39,786,387,399
166,1,40,986,291,695
166,1,41,748,268,480
166,1,42,990,327,663
166,1,43,555,267,288
166,1,44,737,42,695
166,1,46,734,351,383
166,1,47,746,483,263
166,1,48,882,451,431
166,1,50,736,370,366
166,1,51,831,328,503
166,1,52,770,483,287
166,1,53,732,469,263
166,1,54,755,156,599
166,1,55,856,312,544
166,1,56,772,613,159
166,1,57,779,645,134
166,1,58,775,327,448
166,1,59,794,307,487
166,1,60,793,306,487
166,1,62,695,616,79
166,1,63,800,401,399
166,1,64,579,701,-122
166,1,65,992,353,639
166,1,66,850,522,328
166,1,67,902,367,535
166,1,68,779,460,319
166,1,69,749,238,511
166,1,70,799,328,471
166,1,71,868,373,495
166,1,72,751,237,514
167,1,1,904,1133,-229
167,1,2,766,916,-150
167,1,3,848,810,38
167,1,4,816,806,10
167,1,5,699,700,-1
167,1,6,758,720,38
167,1,7,796,755,41
167,1,8,793,775,18
167,1,9,808,428,380
167,1,10,898,282,616
167,1,11,818,259,559
167,1,12,813,266,547
167,1,13,743,446,297
167,1,14,565,254,311
167,1,15,348,271,77
167,1,16,761,305,456
167,1,17,736,251,485
167,1,18,564,270,294
167,1,19,849,231,618
167,1,20,776,310,466
167,1,21,760,334,426
167,1,22,891,321,570
167,1,23,534,135,399
167,1,24,783,192,591
167,1,25,557,395,162
167,1,27,532,276,256
167,1,28,832,257,575
167,1,29,738,47,691
167,1,30,588,379,209
167,1,31,825,215,610
167,1,32,653,261,392
167,1,33,537,243,294
167,1,34,757,29,728
167,1,35,801,308,493
167,1,36,882,82,800
167,1,37,599,413,186
167,1,38,562,104,458
167,1,39,539,195,344
167,1,40,900,320,580
167,1,41,726,247,479
167,1,42,491,196,295
167,1,43,742,194,548
167,1,44,417,307,110
167,1,45,751,651,100
167,1,46,530,142,388
167,1,47,622,298,324
167,1,48,530,307,223
167,1,49,374,267,107
167,1,51,560,261,299
167,1,52,730,117,613
167,1,53,591,269,322
167,1,54,460,319,141
167,1,55,696,451,245
167,1,56,801,412,389
167,1,57,682,24,658
167,1,59,602,425,177
167,1,60,790,262,528
167,1,61,1020,235,785
167,1,62,584,162,422
167,1,63,709,380,329
167,1,64,763,237,526
167,1,65,655,271,384
167,1,66,830,88,742
167,1,67,615,256,359
167,1,68,688,230,458
167,1,69,671,14,657
167,1,70,632,37,595
167,1,71,540,270,270
167,1,72,870,255,615
168,2,1,992,1391,-399
168,2,2,1161,1022,139
168,2,3,862,1008,-146
168,2,4,963,931,32
168,2,5,901,886,15
168,2,6,1002,986,16
168,2,7,914,808,106
168,2,8,1013,912,101
168,2,9,861,936,-75
168,2,10,940,822,118
168,2,11,881,640,241
168,2,12,877,679,198
168,2,13,886,761,125
168,2,15,1092,717,375
168,2,16,887,715,172
168,2,17,883,879,4
168,2,18,884,918,-34
168,2,19,961,996,-35
168,2,20,841,1036,-195
168,2,21,881,683,198
168,2,23,874,1013,-139
168,2,24,882,1054,-172
168,2,25,907,765,142
168,2,26,1442,1261,181
168,2,27,1071,865,206
168,2,28,913,884,29
168,2,29,1002,1020,-18
168,2,30,1020,959,61
168,2,31,1035,894,141
168,2,32,909,889,20
168,2,33,1156,909,247
168,2,34,875,987,-112
168,2,36,928,851,77
168,2,38,890,693,197
168,2,39,899,639,260
168,2,40,865,732,133
168,2,42,989,938,51
168,2,43,918,783,135
168,2,46,1046,1865,-819
168,2,47,1406,858,548
168,2,48,1278,830,448
168,2,49,1021,824,197
168,2,51,1083,925,158
168,2,61,840,1133,-293
168,2,62,925,1086,-161
168,2,63,1144,1003,141
168,2,64,1009,1163,-154
168,2,65,1344,1011,333
168,2,66,1120,1139,-19
168,2,67,985,1013,-28
168,2,68,973,1097,-124
168,2,69,1179,1054,125
168,2,70,1609,1046,563
168,2,71,1215,1050,165
169,3,2,999,1216,-217
169,3,3,961,1308,-347
169,3,4,1003,1068,-65
169,3,5,964,1131,-167
169,3,6,947,996,-49
169,3,7,950,984,-34
169,3,8,925,1280,-355
169,3,9,948,1054,-106
169,3,11,964,1159,-195
169,3,12,968,1029,-61
169,3,13,1134,943,191
169,3,14,885,1071,-186
169,3,15,956,938,18
169,3,16,904,833,71
169,3,17,866,1140,-274
169,3,18,935,922,13
169,3,19,902,431,471
169,3,20,864,874,-10
169,3,21,907,790,117
169,3,22,894,411,483
169,3,23,900,422,478
169,3,24,901,285,616
169,3,25,873,609,264
169,3,26,906,435,471
169,3,27,996,311,685
169,3,28,875,388,487
169,3,29,933,391,542
169,3,30,971,372,599
169,3,31,891,422,469
169,3,32,885,326,559
169,3,33,848,295,553
169,3,34,895,190,705
169,3,35,806,304,502
169,3,36,1020,415,605
169,3,37,857,360,497
169,3,38,867,52,815
169,3,39,919,101,818
169,3,40,783,153,630
169,3,41,717,13,704
169,3,42,864,270,594
169,3,43,663,297,366
169,3,44,851,180,671
169,3,45,907,278,629
169,3,46,742,296,446
169,3,47,803,132,671
169,3,48,908,78,830
169,3,49,816,268,548
169,3,50,1044,38,1006
169,3,51,926,30,896
169,3,52,817,25,792
169,3,53,823,73,750
169,3,54,833,99,734
169,3,55,822,313,509
169,3,56,881,532,349
169,3,57,829,176,653
169,3,58,806,1,805
169,3,59,916,478,438
169,3,60,862,513,349
169,3,61,837,128,709
169,3,62,897,170,727
169,3,63,864,162,702
169,3,64,844,573,271
169,3,65,802,529,273
169,3,66,845,134,711
169,3,67,876,103,773
169,3,68,879,151,728
169,3,70,792,403,389
169,3,71,827,692,135
169,3,72,1058,145,913
170,3,1,1047,1412,-365
170,3,2,1053,1240,-187
170,3,3,993,1336,-343
170,3,4,1280,1090,190
170,3,5,1039,947,92
170,3,6,892,776,116
170,3,7,837,853,-16
170,3,8,859,1004,-145
170,3,9,998,777,221
170,3,10,994,946,48
170,3,11,977,793,184
170,3,12,920,764,156
170,3,13,840,775,65
170,3,14,800,749,51
170,3,15,855,680,175
170,3,16,874,783,91
170,3,17,830,812,18
170,3,18,915,777,138
170,3,19,933,726,207
170,3,20,867,708,159
170,3,21,717,668,49
170,3,22,742,867,-125
170,3,23,871,846,25
170,3,24,966,680,286
170,3,25,892,775,117
170,3,26,847,706,141
170,3,27,767,697,70
170,3,28,815,872,-57
170,3,29,726,744,-18
170,3,30,815,746,69
170,3,31,877,723,154
170,3,32,811,759,52
170,3,33,856,808,48
170,3,34,989,700,289
170,3,35,909,657,252
170,3,36,748,658,90
170,3,37,860,729,131
170,3,38,739,758,-19
170,3,39,772,747,25
170,3,40,854,705,149
170,3,41,779,732,47
170,3,42,854,813,41
170,3,43,736,774,-38
170,3,44,778,817,-39
170,3,46,763,690,73
170,3,47,1026,713,313
170,3,48,795,734,61
170,3,49,826,792,34
170,3,50,767,1063,-296
170,3,52,987,794,193
170,3,54,817,783,34
170,3,55,856,747,109
170,3,56,837,862,-25
170,3,57,930,765,165
170,3,58,864,828,36
170,3,59,735,841,-106
170,3,60,809,686,123
170,3,61,830,655,175
170,3,62,792,790,2
170,3,63,877,707,170
170,3,64,815,725,90
170,3,65,804,797,7
170,3,66,844,671,173
170,3,67,775,685,90
170,3,68,741,737,4
170,3,69,857,728,129
170,3,70,936,790,146
170,3,71,731,790,-59
170,3,72,826,711,115
171,3,1,1230,1392,-162
171,3,2,1307,1107,200
171,3,3,1050,1109,-59
171,3,4,1081,1028,53
171,3,5,1118,1130,-12
171,3,6,1012,1006,6
171,3,7,1027,982,45
171,3,8,1013,1101,-88
171,3,9,925,1000,-75
171,3,10,962,954,8
171,3,11,1059,1142,-83
171,3,12,1078,1069,9
171,3,14,961,971,-10
171,3,15,956,967,-11
171,3,16,984,932,52
171,3,17,960,1057,-97
171,3,18,1006,894,112
171,3,19,917,991,-74
171,3,20,1076,951,125
171,3,21,889,1035,-146
171,3,22,841,1185,-344
171,3,23,876,1054,-178
171,3,24,890,1004,-114
171,3,25,1070,869,201
171,3,26,1016,995,21
171,3,27,913,970,-57
171,3,28,974,1024,-50
171,3,29,933,1015,-82
171,3,30,889,938,-49
171,3,31,893,992,-99
171,3,32,953,929,24
171,3,33,910,976,-66
171,3,34,961,1060,-99
171,3,35,907,1021,-114
171,3,36,856,1100,-244
171,3,37,853,959,-106
171,3,38,874,934,-60
171,3,39,1024,1113,-89
171,3,40,850,1052,-202
171,3,41,1115,1110,5
171,3,42,883,972,-89
171,3,43,968,1003,-35
171,3,44,872,991,-119
171,3,45,963,1084,-121
171,3,46,903,971,-68
171,3,48,922,1068,-146
171,3,49,1092,890,202
171,3,50,994,1073,-79
171,3,51,934,992,-58
171,3,52,909,886,23
171,3,53,873,1140,-267
171,3,54,1013,947,66
171,3,55,979,907,72
171,3,56,928,915,13
171,3,57,883,989,-106
171,3,58,883,1245,-362
171,3,60,1002,845,157
171,3,61,883,972,-89
171,3,62,906,915,-9
171,3,63,832,868,-36
171,3,64,962,931,31
171,3,65,1081,962,119
171,3,66,879,1026,-147
171,3,67,934,969,-35
171,3,68,954,1077,-123
171,3,69,897,834,63
171,3,70,928,906,22
171,3,71,900,1095,-195
171,3,72,1003,917,86
172,3,1,1064,868,196
172,3,2,1064,1016,48
172,3,3,960,844,116
172,3,4,908,716,192
172,3,5,856,904,-48
172,3,6,856,840,16
172,3,7,984,916,68
172,3,8,724,756,-32
172,3,9,928,828,100
172,3,10,816,828,-12
172,3,11,960,912,48
172,3,12,824,780,44
172,3,13,1256,704,552
172,3,14,732,712,20
172,3,15,856,708,148
172,3,16,780,792,-12
172,3,17,876,904,-28
172,3,18,760,692,68
172,3,19,800,736,64
172,3,20,740,776,-36
172,3,21,708,732,-24
172,3,22,845,928,-83
172,3,23,876,808,68
172,3,24,664,768,-104
172,3,25,756,656,100
172,3,26,783,812,-29
172,3,27,812,752,60
172,3,28,764,768,-4
172,3,29,800,820,-20
172,3,30,776,744,32
172,3,31,756,852,-96
172,3,32,804,644,160
172,3,33,836,748,88
172,3,34,788,680,108
172,3,35,876,712,164
172,3,36,792,676,116
172,3,37,844,620,224
172,3,38,760,700,60
172,3,39,764,804,-40
172,3,40,700,736,-36
172,3,41,712,714,-2
172,3,42,732,728,4
172,3,43,715,756,-41
172,3,44,680,692,-12
172,3,45,748,756,-8
172,3,46,780,968,-188
172,3,47,828,748,80
172,3,48,820,616,204
172,3,49,688,796,-108
172,3,50,909,972,-63
172,3,51,740,656,84
172,3,52,728,696,32
172,3,53,712,656,56
172,3,54,812,680,132
172,3,55,764,732,32
172,3,56,784,720,64
172,3,57,744,720,24
172,3,58,716,708,8
172,3,59,864,776,88
172,3,60,728,700,28
172,3,61,1220,608,612
172,3,62,732,692,40
172,3,63,692,712,-20
172,3,64,1156,640,516
172,3,65,756,752,4
172,3,66,760,736,24
172,3,67,780,716,64
172,3,68,1020,736,284
172,3,69,700,632,68
172,3,70,835,720,115
172,3,71,944,648,296
172,3,72,704,736,-32
173,3,1,1076,1497,-421
173,3,2,965,1194,-229
173,3,3,1031,1360,-329
173,3,4,1125,1183,-58
173,3,5,1256,1005,251
173,3,7,960,1132,-172
173,3,8,1079,1054,25
173,3,9,895,1275,-380
173,3,10,932,1105,-173
173,3,11,913,1084,-171
173,3,12,937,983,-46
173,3,13,1137,1029,108
173,3,14,940,1126,-186
173,3,15,939,932,7
173,3,16,1012,1000,12
173,3,17,902,955,-53
173,3,18,939,1157,-218
173,3,19,845,1083,-238
173,3,20,1071,1001,70
173,3,21,950,1049,-99
173,3,22,946,1077,-131
173,3,23,915,876,39
173,3,24,908,961,-53
173,3,25,1039,972,67
173,3,26,852,1028,-176
173,3,27,788,847,-59
173,3,28,861,872,-11
173,3,29,706,681,25
173,3,30,783,836,-53
173,3,31,737,642,95
173,3,32,930,884,46
173,3,34,849,1094,-245
173,3,35,761,700,61
173,3,36,835,719,116
173,3,37,863,775,88
173,3,38,1006,867,139
173,3,39,757,793,-36
173,3,40,817,879,-62
173,3,41,935,790,145
173,3,42,794,829,-35
173,3,43,676,806,-130
173,3,44,842,980,-138
173,3,45,901,911,-10
173,3,46,769,721,48
173,3,47,698,668,30
173,3,48,696,773,-77
173,3,49,1059,701,358
173,3,50,931,784,147
173,3,51,942,808,134
173,3,52,773,650,123
173,3,53,798,688,110
173,3,54,743,747,-4
173,3,55,807,834,-27
173,3,56,803,690,113
173,3,57,986,776,210
173,3,58,1004,686,318
173,3,59,1024,1055,-31
173,3,60,810,645,165
173,3,61,720,669,51
173,3,62,746,833,-87
173,3,63,776,744,32
173,3,64,726,636,90
173,3,65,849,774,75
173,3,66,816,801,15
173,3,67,708,702,6
173,3,68,716,704,12
173,3,69,859,684,175
173,3,70,757,722,35
173,3,71,901,669,232
174,3,1,818,1046,-228
174,3,2,809,785,24
174,3,3,873,771,102
174,3,4,943,1030,-87
174,3,5,1040,773,267
174,3,6,957,868,89
174,3,7,872,828,44
174,3,8,883,757,126
174,3,9,912,672,240
174,3,11,795,819,-24
174,3,12,802,1062,-260
174,3,13,853,594,259
174,3,14,1002,874,128
174,3,15,847,676,171
174,3,16,919,711,208
174,3,17,748,827,-79
174,3,19,944,826,118
174,3,22,774,791,-17
174,3,23,1538,1015,523
174,3,24,823,630,193
174,3,25,919,916,3
174,3,26,947,941,6
174,3,27,911,902,9
174,3,29,915,1031,-116
174,3,30,935,964,-29
174,3,31,935,1031,-96
174,3,32,1031,1000,31
174,3,33,987,996,-9
174,3,34,954,1009,-55
174,3,35,1142,1070,72
174,3,36,933,747,186
174,3,37,815,741,74
174,3,38,790,644,146
174,3,39,717,650,67
174,3,41,881,611,270
174,3,42,796,773,23
174,3,43,738,635,103
174,3,44,773,786,-13
174,3,45,723,756,-33
174,3,46,819,655,164
174,3,47,908,1140,-232
174,3,48,1098,827,271
174,3,49,819,640,179
174,3,50,784,597,187
174,3,52,996,694,302
174,3,53,1058,1201,-143
174,3,55,989,1078,-89
174,3,56,921,1057,-136
174,3,57,1023,1136,-113
174,3,58,870,714,156
174,3,60,1019,1393,-374
174,3,61,1129,1278,-149
174,3,62,1174,606,568
174,3,64,848,735,113
174,3,65,868,699,169
174,3,66,843,646,197
174,3,67,834,937,-103
174,3,68,855,744,111
174,3,69,697,729,-32
174,3,70,723,632,91
174,3,71,756,681,75
174,3,72,724,804,-80
175,3,1,909,1141,-232
175,3,2,878,1023,-145
175,3,3,850,796,54
175,3,4,1021,1020,1
175,3,5,885,1054,-169
175,3,6,1010,973,37
175,3,7,855,1120,-265
175,3,8,863,990,-127
175,3,9,828,1169,-341
175,3,10,950,1097,-147
175,3,11,901,1343,-442
175,3,12,863,957,-94
175,3,13,792,867,-75
175,3,14,835,1042,-207
175,3,15,812,956,-144
175,3,16,782,810,-28
175,3,17,842,1010,-168
175,3,18,875,1110,-235
175,3,19,815,767,48
175,3,20,796,849,-53
175,3,21,765,946,-181
175,3,22,779,1059,-280
175,3,23,799,1006,-207
175,3,24,774,1004,-230
175,3,25,949,726,223
175,3,26,796,917,-121
175,3,27,776,865,-89
175,3,28,808,867,-59
175,3,29,855,1006,-151
175,3,30,847,783,64
175,3,31,840,886,-46
175,3,32,791,978,-187
175,3,33,708,765,-57
175,3,34,758,944,-186
175,3,35,793,657,136
175,3,36,695,672,23
175,3,37,941,847,94
175,3,38,851,756,95
175,3,39,805,871,-66
175,3,40,712,863,-151
175,3,41,846,1014,-168
175,3,42,765,807,-42
175,3,43,794,1013,-219
175,3,44,714,910,-196
175,3,45,822,820,2
175,3,46,751,869,-118
175,3,47,771,698,73
175,3,48,766,699,67
175,3,50,817,767,50
175,3,51,770,961,-191
175,3,52,692,805,-113
175,3,53,742,744,-2
175,3,54,746,919,-173
175,3,55,802,835,-33
175,3,56,742,885,-143
175,3,57,832,741,91
175,3,58,855,696,159
175,3,59,754,642,112
175,3,61,729,668,61
175,3,62,744,852,-108
175,3,63,687,851,-164
175,3,64,769,815,-46
175,3,65,873,669,204
175,3,66,614,803,-189
175,3,67,769,739,30
175,3,70,829,755,74
175,3,71,725,692,33
175,3,72,708,685,23
176,1,1,1103,1358,-255
176,1,2,1009,1171,-162
176,1,3,1123,1127,-4
176,1,4,1119,1560,-441
176,1,5,1052,1333,-281
176,1,6,944,1258,-314
176,1,7,1049,1183,-134
176,1,8,626,50,576
176,1,9,633,540,93
176,1,10,538,403,135
176,1,11,829,982,-153
176,1,12,539,1006,-467
176,1,13,602,915,-313
176,1,14,967,1159,-192
176,1,15,1260,957,303
176,1,16,432,489,-57
176,1,17,698,411,287
176,1,18,936,915,21
176,1,19,1011,1159,-148
176,1,20,1035,1165,-130
176,1,21,991,984,7
176,1,22,1019,1134,-115
176,1,23,1001,931,70
176,1,24,950,1815,-865
176,1,25,1121,842,279
176,1,26,863,720,143
176,1,27,773,821,-48
176,1,29,664,490,174
176,1,30,900,589,311
176,1,31,1006,673,333
176,1,32,1024,800,224
176,1,33,1065,827,238
176,1,34,948,806,142
176,1,35,953,578,375
176,1,36,705,569,136
176,1,37,1253,844,409
176,1,38,773,823,-50
176,1,39,884,787,97
176,1,40,1051,1237,-186
176,1,41,865,808,57
176,1,42,887,344,543
176,1,43,842,660,182
176,1,44,965,670,295
176,1,45,935,1064,-129
176,1,46,1338,1051,287
176,1,47,848,673,175
176,1,48,976,815,161
176,1,49,1013,774,239
176,1,50,990,821,169
176,1,51,834,641,193
176,1,52,886,741,145
176,1,53,404,396,8
176,1,55,886,895,-9
176,1,56,953,578,375
176,1,57,742,513,229
176,1,58,890,516,374
176,1,59,959,840,119
176,1,60,826,803,23
176,1,61,871,457,414
176,1,62,866,643,223
176,1,63,865,674,191
176,1,64,811,965,-154
176,1,66,977,610,367
176,1,67,877,798,79
176,1,70,682,371,311
176,1,71,816,641,175
176,1,72,903,832,71
177,2,3,1022,1600,-578
177,2,4,1048,1729,-681
177,2,5,928,1243,-315
177,2,6,1045,1304,-259
177,2,7,983,1064,-81
177,2,8,975,1257,-282
177,2,9,1001,1394,-393
177,2,10,904,923,-19
177,2,11,867,1087,-220
177,2,13,918,976,-58
177,2,14,850,949,-99
177,2,15,1328,1050,278
177,2,16,982,937,45
177,2,17,1063,904,159
177,2,18,1069,1184,-115
177,2,19,838,966,-128
177,2,20,893,990,-97
177,2,21,772,855,-83
177,2,22,1003,1021,-18
177,2,23,826,830,-4
177,2,24,826,887,-61
177,2,25,877,710,167
177,2,26,822,775,47
177,2,27,1121,1355,-234
177,2,28,1224,956,268
177,2,29,834,868,-34
177,2,30,1260,774,486
177,2,31,832,642,190
177,2,33,850,999,-149
177,2,34,1029,872,157
177,2,35,934,888,46
177,2,36,913,837,76
177,2,37,877,865,12
177,2,38,855,874,-19
177,2,39,876,886,-10
177,2,40,964,870,94
177,2,41,917,912,5
177,2,42,934,1050,-116
177,2,43,886,1267,-381
177,2,44,946,894,52
177,2,45,852,975,-123
177,2,46,935,987,-52
177,2,47,947,734,213
177,2,48,1028,862,166
177,2,50,1178,1133,45
177,2,51,883,838,45
177,2,52,861,1024,-163
177,2,53,854,1081,-227
177,2,54,949,960,-11
177,2,56,985,957,28
177,2,57,953,645,308
177,2,58,1010,893,117
177,2,59,842,958,-116
177,2,60,853,1078,-225
177,2,61,1030,1305,-275
177,2,62,1240,781,459
177,2,63,921,1339,-418
177,2,64,946,780,166
177,2,65,758,961,-203
177,2,66,1175,1097,78
177,2,67,939,1012,-73
177,2,68,698,1235,-537
177,2,69,931,996,-65
177,2,70,1042,989,53
177,2,71,1061,905,156
177,2,72,1034,1118,-84
178,2,1,1060,1209,-149
178,2,2,907,1044,-137
178,2,3,1109,886,223
178,2,4,1129,1090,39
178,2,5,1213,1094,119
178,2,6,1052,985,67
178,2,7,1038,906,132
178,2,8,1087,923,164
178,2,9,912,1005,-93
178,2,10,1012,1034,-22
178,2,11,945,1117,-172
178,2,12,1003,910,93
178,2,13,888,846,42
178,2,14,1023,900,123
178,2,15,916,947,-31
178,2,16,849,1117,-268
178,2,17,1244,968,276
178,2,18,893,957,-64
178,2,19,1075,836,239
178,2,20,840,900,-60
178,2,21,924,829,95
178,2,23,942,1633,-691
178,2,24,1074,1141,-67
178,2,25,1380,936,444
178,2,26,1141,885,256
178,2,27,1004,895,109
178,2,28,955,865,90
178,2,29,919,838,81
178,2,30,961,1095,-134
178,2,31,868,794,74
178,2,32,897,990,-93
178,2,33,910,855,55
178,2,34,983,1015,-32
178,2,35,823,938,-115
178,2,36,1049,885,164
178,2,37,911,807,104
178,2,38,1002,949,53
178,2,39,950,870,80
178,2,40,1108,965,143
178,2,41,905,904,1
178,2,42,1017,926,91
178,2,43,1108,1033,75
178,2,44,880,880,0
178,2,45,921,1183,-262
178,2,46,948,1149,-201
178,2,48,855,1324,-469
178,2,49,871,820,51
178,2,50,1051,980,71
178,2,51,918,1190,-272
178,2,53,895,1047,-152
178,2,54,834,1047,-213
178,2,55,880,1763,-883
178,2,56,994,806,188
178,2,57,1092,898,194
178,2,59,870,914,-44
178,2,61,904,995,-91
178,2,62,1028,858,170
178,2,63,877,1017,-140
178,2,64,980,908,72
178,2,65,918,899,19
178,2,66,1146,875,271
178,2,67,1005,933,72
178,2,68,1164,773,391
178,2,69,931,906,25
178,2,70,919,873,46
178,2,71,922,919,3
178,2,72,830,920,-90
179,1,1,1185,948,237
179,1,2,1222,867,355
179,1,3,1223,816,407
179,1,4,1079,727,352
179,1,5,1075,720,355
179,1,6,1138,767,371
179,1,7,1260,780,480
179,1,8,1120,749,371
179,1,9,1157,1085,72
179,1,10,820,666,154
179,1,11,927,735,192
179,1,12,932,926,6
179,1,13,822,713,109
179,1,14,856,623,233
179,1,15,862,716,146
179,1,16,904,671,233
179,1,17,1027,700,327
179,1,18,862,664,198
179,1,19,1089,779,310
179,1,20,1109,821,288
179,1,21,1024,679,345
179,1,22,1031,750,281
179,1,23,879,702,177
179,1,24,854,707,147
179,1,26,864,654,210
179,1,27,844,776,68
179,1,28,768,728,40
179,1,29,770,731,39
179,1,30,853,706,147
179,1,31,865,844,21
179,1,32,1234,771,463
179,1,33,1057,711,346
179,1,34,811,706,105
179,1,35,835,845,-10
179,1,36,868,643,225
179,1,37,734,732,2
179,1,38,813,727,86
179,1,39,797,696,101
179,1,40,833,687,146
179,1,41,803,712,91
179,1,42,767,733,34
179,1,43,794,732,62
179,1,44,914,796,118
179,1,45,755,654,101
179,1,46,707,687,20
179,1,47,872,801,71
179,1,48,1052,668,384
179,1,49,733,724,9
179,1,50,776,770,6
179,1,51,872,687,185
179,1,52,750,623,127
179,1,53,744,669,75
179,1,54,730,641,89
179,1,55,794,682,112
179,1,56,824,658,166
179,1,57,818,613,205
179,1,58,762,637,125
179,1,59,858,682,176
179,1,60,820,702,118
179,1,61,943,730,213
179,1,62,798,720,78
179,1,63,752,710,42
179,1,64,872,696,176
179,1,65,827,740,87
179,1,66,841,743,98
179,1,67,773,689,84
179,1,68,781,609,172
179,1,69,807,659,148
179,1,70,832,686,146
179,1,71,928,681,247
179,1,72,828,782,46
180,1,1,780,913,-133
180,1,2,879,812,67
180,1,3,985,655,330
180,1,4,740,836,-96
180,1,5,744,765,-21
180,1,6,695,596,99
180,1,7,785,798,-13
180,1,9,781,609,172
180,1,10,421,340,81
180,1,11,772,284,488
180,1,12,438,336,102
180,1,13,748,306,442
180,1,14,566,259,307
180,1,16,767,440,327
180,1,17,705,332,373
180,1,18,608,300,308
180,1,20,733,280,453
180,1,21,800,421,379
180,1,22,804,316,488
180,1,23,724,285,439
180,1,24,672,288,384
180,1,25,716,316,400
180,1,26,632,140,492
180,1,27,760,92,668
180,1,29,746,284,462
180,1,30,740,116,624
180,1,31,852,316,536
180,1,32,732,320,412
180,1,33,716,316,400
180,1,34,739,132,607
180,1,35,431,292,139
180,1,37,828,415,413
180,1,38,596,324,272
180,1,39,748,308,440
180,1,41,592,324,268
180,1,42,686,433,253
180,1,43,584,265,319
180,1,44,680,489,191
180,1,45,756,373,383
180,1,46,788,396,392
180,1,47,744,292,452
180,1,48,744,276,468
180,1,49,608,296,312
180,1,50,646,380,266
180,1,51,786,352,434
180,1,52,744,276,468
180,1,53,708,248,460
180,1,56,488,88,400
180,1,59,750,348,402
180,1,60,727,344,383
180,1,61,136,300,-164
180,1,62,760,244,516
180,1,64,888,285,603
180,1,65,728,356,372
180,1,66,795,316,479
180,1,67,749,252,497
180,1,68,688,128,560
180,1,69,733,274,459
180,1,70,792,260,532
180,1,71,717,280,437
180,1,72,794,172,622
181,2,1,944,1373,-429
181,2,2,928,1337,-409
181,2,3,999,1182,-183
181,2,4,981,1126,-145
181,2,5,850,1126,-276
181,2,6,885,1066,-181
181,2,7,1017,1074,-57
181,2,8,867,998,-131
181,2,9,983,925,58
181,2,10,831,903,-72
181,2,11,900,922,-22
181,2,12,978,931,47
181,2,13,874,799,75
181,2,14,883,874,9
181,2,15,984,763,221
181,2,16,854,1174,-320
181,2,17,937,874,63
181,2,18,899,811,88
181,2,19,906,882,24
181,2,20,874,780,94
181,2,21,800,858,-58
181,2,22,833,1159,-326
181,2,23,831,1133,-302
181,2,24,922,830,92
181,2,25,871,874,-3
181,2,26,904,1048,-144
181,2,27,795,869,-74
181,2,28,869,918,-49
181,2,29,858,783,75
181,2,30,683,879,-196
181,2,31,811,779,32
181,2,32,864,794,70
181,2,33,803,725,78
181,2,34,820,736,84
181,2,35,732,838,-106
181,2,38,672,784,-112
181,2,39,831,713,118
181,2,40,725,836,-111
181,2,41,921,746,175
181,2,42,761,751,10
181,2,43,798,736,62
181,2,44,1113,793,320
181,2,45,449,523,-74
181,2,46,863,899,-36
181,2,47,404,529,-125
181,2,48,722,790,-68
181,2,49,615,521,94
181,2,50,726,743,-17
181,2,51,870,715,155
181,2,52,835,333,502
181,2,53,703,646,57
181,2,54,746,555,191
181,2,55,737,251,486
181,2,56,419,857,-438
181,2,57,799,337,462
181,2,58,550,365,185
181,2,59,769,420,349
181,2,60,529,276,253
181,2,61,486,224,262
181,2,62,576,399,177
181,2,63,591,186,405
181,2,64,552,889,-337
181,2,65,846,236,610
181,2,66,633,191,442
181,2,67,825,218,607
181,2,68,798,211,587
181,2,69,499,387,112
181,2,70,522,195,327
181,2,71,808,33,775
181,2,72,588,274,314
182,2,1,1069,1246,-177
182,2,2,1310,1293,17
182,2,3,1172,1169,3
182,2,4,1037,1047,-10
182,2,5,1119,1005,114
182,2,6,1172,1081,91
182,2,7,1116,1190,-74
182,2,8,1027,1119,-92
182,2,9,1010,1026,-16
182,2,10,1003,1017,-14
182,2,11,1106,1194,-88
182,2,12,966,1184,-218
182,2,13,1022,1017,5
182,2,14,887,1050,-163
182,2,15,1107,1031,76
182,2,16,1037,931,106
182,2,17,978,914,64
182,2,18,1198,988,210
182,2,19,1015,912,103
182,2,20,865,1013,-148
182,2,21,1029,1092,-63
182,2,22,1131,1036,95
182,2,23,1082,1081,1
182,2,24,1274,1147,127
182,2,25,948,935,13
182,2,26,1006,817,189
182,2,27,1005,866,139
182,2,28,1064,474,590
182,2,29,1162,465,697
182,2,30,1313,1070,243
182,2,31,1054,1079,-25
182,2,32,1112,1065,47
182,2,33,1056,838,218
182,2,34,1004,1007,-3
182,2,35,1103,960,143
182,2,36,1189,1064,125
182,2,37,998,1030,-32
182,2,38,1168,975,193
182,2,39,953,1011,-58
182,2,40,1123,1157,-34
182,2,41,979,1081,-102
182,2,42,1042,966,76
182,2,43,1181,1031,150
182,2,44,1133,1006,127
182,2,45,930,1019,-89
182,2,46,885,1010,-125
182,2,47,975,997,-22
182,2,48,858,293,565
182,2,49,905,1062,-157
182,2,50,1164,1031,133
182,2,51,999,1016,-17
182,2,52,946,1099,-153
182,2,53,986,998,-12
182,2,54,1000,1000,0
182,2,55,1003,1247,-244
182,2,56,1202,1137,65
182,2,57,1058,974,84
182,2,58,1145,990,155
182,2,59,949,1034,-85
182,2,60,1075,1030,45
182,2,61,1703,937,766
182,2,62,1103,835,268
182,2,63,1181,958,223
182,2,64,1026,1004,22
182,2,66,1226,1156,70
182,2,67,984,1114,-130
182,2,68,982,1171,-189
182,2,69,1016,1145,-129
182,2,70,1094,1159,-65
182,2,71,990,1043,-53
182,2,72,910,905,5
183,1,1,963,1042,-79
183,1,2,920,982,-62
183,1,3,929,933,-4
183,1,4,1082,754,328
183,1,5,1006,950,56
183,1,6,898,177,721
183,1,7,739,132,607
183,1,8,992,156,836
183,1,9,804,348,456
183,1,10,784,160,624
183,1,11,851,179,672
183,1,12,764,307,457
183,1,14,816,311,505
183,1,15,843,188,655
183,1,16,897,333,564
183,1,17,813,591,222
183,1,18,834,404,430
183,1,20,818,354,464
183,1,21,712,60,652
183,1,22,820,337,483
183,1,23,751,21,730
183,1,24,746,215,531
183,1,25,804,279,525
183,1,26,758,99,659
183,1,27,599,317,282
183,1,28,800,399,401
183,1,29,906,324,582
183,1,30,707,536,171
183,1,33,854,280,574
183,1,34,798,241,557
183,1,35,765,202,563
183,1,36,750,210,540
183,1,37,715,289,426
183,1,38,763,144,619
183,1,39,849,555,294
183,1,40,886,166,720
183,1,41,699,49,650
183,1,42,695,249,446
183,1,43,1002,272,730
183,1,44,769,136,633
183,1,45,756,268,488
183,1,46,708,323,385
183,1,47,773,218,555
183,1,48,803,485,318
183,1,49,726,227,499
183,1,50,719,33,686
183,1,51,746,421,325
183,1,52,678,325,353
183,1,53,793,285,508
183,1,54,803,403,400
183,1,55,713,445,268
183,1,57,735,317,418
183,1,58,756,316,440
183,1,59,803,449,354
183,1,60,791,399,392
183,1,61,1035,307,728
183,1,62,740,357,383
183,1,63,706,419,287
183,1,64,885,476,409
183,1,65,768,291,477
183,1,66,704,285,419
183,1,67,811,655,156
183,1,68,740,290,450
183,1,69,771,197,574
183,1,70,719,471,248
183,1,71,758,185,573
183,1,72,886,290,596
184,3,1,853,1151,-298
184,3,2,844,1124,-280
184,3,3,935,950,-15
184,3,4,856,1002,-146
184,3,5,1001,993,8
184,3,6,896,965,-69
184,3,7,914,990,-76
184,3,8,1010,1055,-45
184,3,9,972,915,57
184,3,10,943,1016,-73
184,3,11,1054,1062,-8
184,3,12,886,875,11
184,3,13,918,896,22
184,3,14,933,907,26
184,3,15,898,836,62
184,3,16,914,974,-60
184,3,17,895,836,59
184,3,18,967,1010,-43
184,3,19,906,988,-82
184,3,20,877,953,-76
184,3,21,866,1017,-151
184,3,22,876,988,-112
184,3,23,893,972,-79
184,3,24,909,880,29
184,3,25,880,840,40
184,3,26,968,969,-1
184,3,27,928,812,116
184,3,28,971,997,-26
184,3,29,980,839,141
184,3,30,909,969,-60
184,3,31,935,904,31
184,3,32,945,1043,-98
184,3,33,911,953,-42
184,3,34,925,962,-37
184,3,35,813,906,-93
184,3,36,867,992,-125
184,3,37,902,815,87
184,3,38,930,982,-52
184,3,39,1047,922,125
184,3,40,938,900,38
184,3,41,868,848,20
184,3,42,988,930,58
184,3,43,924,856,68
184,3,44,906,945,-39
184,3,45,878,915,-37
184,3,46,828,905,-77
184,3,47,1016,908,108
184,3,48,923,1020,-97
184,3,49,974,903,71
184,3,50,914,885,29
184,3,51,1210,976,234
184,3,52,903,975,-72
184,3,53,902,1130,-228
184,3,54,993,864,129
184,3,55,876,846,30
184,3,56,970,868,102
184,3,57,883,958,-75
184,3,58,969,967,2
184,3,59,1115,914,201
184,3,60,942,1108,-166
184,3,61,853,867,-14
184,3,62,876,860,16
184,3,63,912,923,-11
184,3,64,890,813,77
184,3,65,896,887,9
184,3,66,953,1003,-50
184,3,67,978,854,124
184,3,68,994,977,17
184,3,69,880,998,-118
184,3,70,935,903,32
184,3,71,964,940,24
184,3,72,872,894,-22
185,2,1,1048,1292,-244
185,2,2,1055,1177,-122
185,2,3,935,1051,-116
185,2,4,903,935,-32
185,2,5,935,975,-40
185,2,6,818,415,403
185,2,7,840,987,-147
185,2,8,1058,925,133
185,2,9,914,1271,-357
185,2,10,894,913,-19
185,2,11,608,435,173
185,2,12,1055,553,502
185,2,14,875,533,342
185,2,15,882,358,524
185,2,16,797,310,487
185,2,17,890,263,627
185,2,18,783,257,526
185,2,19,760,240,520
185,2,20,615,330,285
185,2,21,537,262,275
185,2,22,553,258,295
185,2,23,716,265,451
185,2,24,728,260,468
185,2,25,785,287,498
185,2,26,507,260,247
185,2,27,445,245,200
185,2,28,838,225,613
185,2,29,663,242,421
185,2,30,865,857,8
185,2,31,888,665,223
185,2,32,803,1280,-477
185,2,33,997,975,22
185,2,34,767,970,-203
185,2,35,828,518,310
185,2,36,1028,332,696
185,2,37,778,348,430
185,2,38,903,213,690
185,2,39,1055,409,646
185,2,40,1012,421,591
185,2,41,970,247,723
185,2,42,792,255,537
185,2,43,828,155,673
185,2,45,891,805,86
185,2,46,879,330,549
185,2,47,789,325,464
185,2,48,850,75,775
185,2,49,796,872,-76
185,2,50,893,608,285
185,2,51,761,216,545
185,2,52,783,794,-11
185,2,53,1269,1265,4
185,2,54,564,593,-29
185,2,55,783,326,457
185,2,56,885,138,747
185,2,57,674,437,237
185,2,58,655,298,357
185,2,59,866,267,599
185,2,60,880,342,538
185,2,61,429,334,95
185,2,62,682,1039,-357
185,2,63,493,230,263
185,2,64,888,390,498
185,2,65,982,931,51
185,2,66,807,203,604
185,2,67,659,19,640
185,2,68,787,20,767
185,2,69,769,31,738
185,2,70,660,6,654
185,2,71,520,25,495
185,2,72,457,27,430
186,3,1,1094,1538,-444
186,3,2,1174,1282,-108
186,3,3,1232,1284,-52
186,3,4,1056,1219,-163
186,3,5,1099,1077,22
186,3,6,1189,1129,60
186,3,7,963,1232,-269
186,3,8,1143,1211,-68
186,3,9,1128,1228,-100
186,3,10,990,1034,-44
186,3,11,1086,1082,4
186,3,12,1078,1106,-28
186,3,13,1016,932,84
186,3,14,914,1110,-196
186,3,15,1356,1039,317
186,3,16,884,1261,-377
186,3,17,880,1021,-141
186,3,18,844,1001,-157
186,3,19,1197,1418,-221
186,3,20,838,1099,-261
186,3,21,1165,1025,140
186,3,22,988,976,12
186,3,23,965,1065,-100
186,3,24,1085,922,163
186,3,25,1045,1313,-268
186,3,26,1355,998,357
186,3,27,1007,940,67
186,3,28,1328,1211,117
186,3,29,911,1098,-187
186,3,30,875,920,-45
186,3,31,992,1069,-77
186,3,32,1172,1218,-46
186,3,33,1187,1105,82
186,3,34,976,827,149
186,3,35,981,1220,-239
186,3,36,900,992,-92
186,3,37,1108,1088,20
186,3,38,1106,1117,-11
186,3,39,958,1034,-76
186,3,40,907,999,-92
186,3,41,999,1187,-188
186,3,42,1261,1170,91
186,3,43,835,1095,-260
186,3,44,1042,904,138
186,3,45,1049,1005,44
186,3,46,943,1091,-148
186,3,47,953,1117,-164
186,3,48,909,1042,-133
186,3,49,843,1097,-254
186,3,50,816,1111,-295
186,3,51,944,1123,-179
186,3,52,1146,1151,-5
186,3,53,1307,1038,269
186,3,54,916,1121,-205
186,3,55,973,1202,-229
186,3,56,998,1115,-117
186,3,57,1005,953,52
186,3,58,935,1244,-309
186,3,59,962,1263,-301
186,3,60,840,1019,-179
186,3,61,865,1054,-189
186,3,62,1001,950,51
186,3,63,872,1132,-260
186,3,64,895,1171,-276
186,3,65,826,943,-117
186,3,66,952,925,27
186,3,67,1241,1284,-43
186,3,68,1350,1137,213
186,3,69,802,1008,-206
186,3,70,1013,1258,-245
186,3,71,948,1063,-115
186,3,72,1034,1029,5
187,1,1,843,951,-108
187,1,2,861,830,31
187,1,3,813,654,159
187,1,4,865,784,81
187,1,5,876,711,165
187,1,6,716,759,-43
187,1,7,876,736,140
187,1,8,746,783,-37
187,1,9,798,662,136
187,1,10,1002,652,350
187,1,11,960,844,116
187,1,12,712,778,-66
187,1,13,864,684,180
187,1,14,757,662,95
187,1,15,744,710,34
187,1,16,889,1040,-151
187,1,17,720,596,124
187,1,18,868,765,103
187,1,19,744,643,101
187,1,20,690,690,0
187,1,21,1113,714,399
187,1,22,795,797,-2
187,1,23,720,708,12
187,1,24,796,660,136
187,1,25,760,699,61
187,1,26,901,656,245
187,1,27,726,685,41
187,1,28,830,649,181
187,1,29,707,918,-211
187,1,30,733,616,117
187,1,31,810,728,82
187,1,33,742,660,82
187,1,34,689,689,0
187,1,35,753,672,81
187,1,36,709,616,93
187,1,37,821,652,169
187,1,38,699,699,0
187,1,39,816,479,337
187,1,40,628,684,-56
187,1,41,675,691,-16
187,1,42,683,382,301
187,1,43,713,484,229
187,1,44,730,396,334
187,1,46,705,419,286
187,1,47,677,378,299
187,1,48,726,407,319
187,1,49,886,348,538
187,1,50,591,390,201
187,1,52,1097,505,592
187,1,53,1128,409,719
187,1,54,1085,388,697
187,1,55,1025,425,600
187,1,56,971,358,613
187,1,57,1087,1031,56
187,1,58,998,1029,-31
187,1,59,1476,939,537
187,1,60,1108,1049,59
187,1,61,1264,344,920
187,1,62,1082,562,520
187,1,63,1131,569,562
187,1,64,1018,632,386
187,1,65,929,778,151
187,1,66,1090,386,704
187,1,67,1118,292,826
187,1,68,990,396,594
187,1,69,1007,427,580
187,1,70,1076,358,718
187,1,71,1147,372,775
187,1,72,1072,427,645
188,2,1,761,1074,-313
188,2,2,992,1151,-159
188,2,3,930,828,102
188,2,5,807,856,-49
188,2,6,812,943,-131
188,2,7,864,986,-122
188,2,9,872,1000,-128
188,2,10,796,1010,-214
188,2,11,856,847,9
188,2,12,1058,1202,-144
188,2,13,997,767,230
188,2,14,873,821,52
188,2,15,872,939,-67
188,2,16,762,1006,-244
188,2,17,825,874,-49
188,2,18,893,803,90
188,2,19,955,1025,-70
188,2,20,950,816,134
188,2,21,836,819,17
188,2,22,879,880,-1
188,2,23,842,964,-122
188,2,24,885,843,42
188,2,25,772,980,-208
188,2,26,1089,775,314
188,2,27,940,939,1
188,2,28,882,976,-94
188,2,29,797,934,-137
188,2,30,816,908,-92
188,2,31,940,1261,-321
188,2,32,809,920,-111
188,2,33,853,816,37
188,2,34,862,896,-34
188,2,35,1010,821,189
188,2,36,879,955,-76
188,2,37,809,881,-72
188,2,38,806,834,-28
188,2,39,973,696,277
188,2,40,846,1079,-233
188,2,41,792,755,37
188,2,42,876,456,420
188,2,43,923,658,265
188,2,44,897,652,245
188,2,45,854,673,181
188,2,46,756,413,343
188,2,47,871,391,480
188,2,48,873,892,-19
188,2,49,979,545,434
188,2,50,779,389,390
188,2,51,702,343,359
188,2,52,756,358,398
188,2,53,769,287,482
188,2,54,702,391,311
188,2,55,924,483,441
188,2,56,832,287,545
188,2,57,791,287,504
188,2,58,777,578,199
188,2,59,781,599,182
188,2,60,1422,499,923
188,2,61,1369,402,967
188,2,62,779,342,437
188,2,63,781,448,333
188,2,64,1198,352,846
188,2,65,835,386,449
188,2,66,789,518,271
188,2,67,769,636,133
188,2,68,792,333,459
188,2,69,824,306,518
188,2,70,871,438,433
188,2,71,720,467,253
188,2,72,901,470,431
189,3,1,962,1251,-289
189,3,2,893,1365,-472
189,3,3,821,971,-150
189,3,4,891,912,-21
189,3,5,924,1098,-174
189,3,7,932,971,-39
189,3,8,971,1047,-76
189,3,9,867,854,13
189,3,10,927,1032,-105
189,3,11,812,1004,-192
189,3,12,823,879,-56
189,3,13,845,979,-134
189,3,14,860,898,-38
189,3,15,784,951,-167
189,3,16,779,986,-207
189,3,17,906,1037,-131
189,3,18,802,1035,-233
189,3,19,843,898,-55
189,3,20,849,961,-112
189,3,21,813,841,-28
189,3,22,795,900,-105
189,3,23,840,912,-72
189,3,24,753,930,-177
189,3,25,810,1050,-240
189,3,26,839,877,-38
189,3,27,749,876,-127
189,3,28,836,954,-118
189,3,30,789,1057,-268
189,3,31,864,1050,-186
189,3,32,811,921,-110
189,3,33,756,825,-69
189,3,34,746,972,-226
189,3,35,732,884,-152
189,3,36,739,785,-46
189,3,37,759,1013,-254
189,3,38,709,841,-132
189,3,39,784,928,-144
189,3,40,857,1018,-161
189,3,41,797,821,-24
189,3,42,781,942,-161
189,3,43,806,807,-1
189,3,44,738,793,-55
189,3,45,828,816,12
189,3,46,767,1143,-376
189,3,47,894,832,62
189,3,48,768,844,-76
189,3,49,749,815,-66
189,3,50,756,966,-210
189,3,51,845,982,-137
189,3,52,733,720,13
189,3,53,966,923,43
189,3,54,790,926,-136
189,3,55,850,933,-83
189,3,56,768,877,-109
189,3,57,856,816,40
189,3,58,830,875,-45
189,3,59,745,884,-139
189,3,60,768,861,-93
189,3,61,716,857,-141
189,3,62,783,822,-39
189,3,63,738,820,-82
189,3,64,736,875,-139
189,3,65,769,878,-109
189,3,66,794,1117,-323
189,3,67,748,851,-103
189,3,68,837,743,94
189,3,69,844,890,-46
189,3,70,801,921,-120
189,3,71,745,1355,-610
189,3,72,750,975,-225
190,2,1,997,1309,-312
190,2,2,994,1013,-19
190,2,3,965,1421,-456
190,2,4,962,839,123
190,2,5,1475,867,608
190,2,6,918,906,12
190,2,7,901,1487,-586
190,2,8,881,857,24
190,2,9,997,948,49
190,2,10,1001,747,254
190,2,11,950,788,162
190,2,12,889,726,163
190,2,13,835,757,78
190,2,14,1005,831,174
190,2,15,934,1238,-304
190,2,16,930,1003,-73
190,2,17,852,703,149
190,2,18,893,680,213
190,2,19,785,743,42
190,2,20,950,755,195
190,2,21,913,1269,-356
190,2,22,1281,846,435
190,2,23,1015,885,130
190,2,24,902,768,134
190,2,25,895,781,114
190,2,26,1242,747,495
190,2,27,928,1199,-271
190,2,28,945,912,33
190,2,29,954,842,112
190,2,30,1379,872,507
190,2,31,1128,938,190
190,2,32,848,739,109
190,2,33,853,668,185
190,2,34,974,749,225
190,2,35,1366,758,608
190,2,36,1043,960,83
190,2,38,896,1284,-388
190,2,39,1000,764,236
190,2,40,865,727,138
190,2,41,790,913,-123
190,2,42,898,742,156
190,2,43,1079,1282,-203
190,2,44,1489,1314,175
190,2,45,868,940,-72
190,2,46,989,796,193
190,2,47,808,703,105
190,2,48,979,774,205
190,2,49,855,708,147
190,2,50,828,696,132
190,2,51,734,652,82
190,2,53,912,706,206
190,2,54,684,657,27
190,2,55,923,850,73
190,2,56,816,676,140
190,2,57,837,753,84
190,2,58,898,633,265
190,2,59,1005,1190,-185
190,2,60,895,729,166
190,2,61,883,1037,-154
190,2,62,881,943,-62
190,2,63,847,1022,-175
190,2,64,1006,744,262
190,2,65,858,812,46
190,2,66,1277,1122,155
190,2,67,843,853,-10
190,2,68,859,673,186
190,2,69,859,868,-9
190,2,70,831,686,145
190,2,71,810,663,147
190,2,72,859,650,209
191,2,1,1096,1505,-409
191,2,2,863,1307,-444
191,2,3,918,1270,-352
191,2,4,824,1186,-362
191,2,5,786,1145,-359
191,2,6,822,1128,-306
191,2,7,900,1150,-250
191,2,8,778,1007,-229
191,2,9,902,1291,-389
191,2,10,750,1033,-283
191,2,11,974,1052,-78
191,2,12,844,993,-149
191,2,13,832,1066,-234
191,2,14,852,1002,-150
191,2,15,819,912,-93
191,2,16,959,1213,-254
191,2,17,800,763,37
191,2,18,923,1175,-252
191,2,19,789,806,-17
191,2,20,847,1055,-208
191,2,21,873,811,62
191,2,22,784,982,-198
191,2,23,758,988,-230
191,2,24,810,859,-49
191,2,25,746,815,-69
191,2,26,933,1186,-253
191,2,27,709,899,-190
191,2,28,742,1025,-283
191,2,29,786,1306,-520
191,2,30,930,1035,-105
191,2,31,712,835,-123
191,2,32,753,988,-235
191,2,33,707,698,9
191,2,34,807,847,-40
191,2,35,753,813,-60
191,2,36,757,821,-64
191,2,37,882,759,123
191,2,38,690,705,-15
191,2,39,742,788,-46
191,2,40,687,689,-2
191,2,41,723,803,-80
191,2,42,723,785,-62
191,2,43,743,821,-78
191,2,44,826,779,47
191,2,45,888,1224,-336
191,2,46,742,808,-66
191,2,47,747,1056,-309
191,2,48,806,797,9
191,2,49,777,991,-214
191,2,50,1274,1043,231
191,2,51,775,1002,-227
191,2,52,655,696,-41
191,2,53,679,700,-21
191,2,54,827,903,-76
191,2,55,1056,1300,-244
191,2,56,836,736,100
191,2,57,777,734,43
191,2,58,983,822,161
191,2,59,805,831,-26
191,2,60,856,1032,-176
191,2,61,732,753,-21
191,2,62,775,785,-10
191,2,63,762,731,31
191,2,64,749,727,22
191,2,65,813,831,-18
191,2,66,713,1111,-398
191,2,67,830,794,36
191,2,68,777,784,-7
191,2,69,764,742,22
191,2,70,783,868,-85
191,2,71,731,945,-214
191,2,72,748,700,48
192,3,1,965,1513,-548
192,3,2,1060,1361,-301
192,3,3,1061,1239,-178
192,3,4,944,1545,-601
192,3,5,1116,1253,-137
192,3,6,1480,1148,332
192,3,7,1181,1072,109
192,3,8,1425,1321,104
192,3,9,1288,1115,173
192,3,10,1113,1064,49
192,3,11,1056,1161,-105
192,3,12,1196,1153,43
192,3,13,1082,1229,-147
192,3,14,944,1070,-126
192,3,15,1097,1000,97
192,3,16,1136,1101,35
192,3,17,1032,1021,11
192,3,18,1036,980,56
192,3,19,1356,1040,316
192,3,20,956,1021,-65
192,3,21,956,988,-32
192,3,22,696,1056,-360
192,3,23,1080,968,112
192,3,24,1185,1044,141
192,3,26,1040,1016,24
192,3,27,1024,1052,-28
192,3,28,1185,960,225
192,3,29,1248,1000,248
192,3,30,1096,1056,40
192,3,31,985,1152,-167
192,3,32,1101,1125,-24
192,3,33,1188,1073,115
192,3,34,1108,1012,96
192,3,35,1221,1048,173
192,3,36,1061,1029,32
192,3,37,980,956,24
192,3,38,953,969,-16
192,3,39,952,925,27
192,3,40,664,1017,-353
192,3,41,889,1157,-268
192,3,42,964,1102,-138
192,3,43,1064,1118,-54
192,3,44,1024,973,51
192,3,45,1000,889,111
192,3,46,944,984,-40
192,3,47,989,1056,-67
192,3,48,1253,972,281
192,3,49,1093,1020,73
192,3,50,948,989,-41
192,3,51,944,960,-16
192,3,52,1052,1285,-233
192,3,53,1009,1428,-419
192,3,54,909,1092,-183
192,3,55,1024,980,44
192,3,56,948,1152,-204
192,3,57,1013,1044,-31
192,3,58,1168,1096,72
192,3,59,1276,952,324
192,3,61,1052,1121,-69
192,3,62,1069,1160,-91
192,3,63,996,1345,-349
192,3,64,1105,1081,24
192,3,65,1104,1117,-13
192,3,66,957,1108,-151
192,3,67,1301,1110,191
192,3,68,1156,1397,-241
192,3,69,984,1089,-105
192,3,70,1093,1152,-59
192,3,71,912,1221,-309
192,3,72,1121,1192,-71
193,3,1,874,1020,-146
193,3,2,752,923,-171
193,3,3,867,826,41
193,3,4,779,796,-17
193,3,5,844,847,-3
193,3,6,1035,961,74
193,3,7,745,705,40
193,3,8,845,733,112
193,3,9,810,820,-10
193,3,10,760,661,99
193,3,11,883,896,-13
193,3,12,786,603,183
193,3,14,764,1023,-259
193,3,15,735,524,211
193,3,16,674,625,49
193,3,17,1007,745,262
193,3,18,679,675,4
193,3,19,872,734,138
193,3,20,947,870,77
193,3,21,669,687,-18
193,3,22,612,519,93
193,3,23,912,718,194
193,3,24,741,632,109
193,3,25,696,857,-161
193,3,26,660,632,28
193,3,27,681,713,-32
193,3,28,716,703,13
193,3,29,828,684,144
193,3,30,654,699,-45
193,3,31,693,457,236
193,3,32,782,715,67
193,3,33,729,846,-117
193,3,34,762,639,123
193,3,35,740,907,-167
193,3,36,653,590,63
193,3,37,788,700,88
193,3,38,660,611,49
193,3,39,648,593,55
193,3,40,720,668,52
193,3,41,710,714,-4
193,3,43,722,809,-87
193,3,44,652,666,-14
193,3,45,732,722,10
193,3,46,691,653,38
193,3,47,805,720,85
193,3,48,742,742,0
193,3,49,825,708,117
193,3,50,731,659,72
193,3,51,686,620,66
193,3,52,655,685,-30
193,3,53,642,817,-175
193,3,54,694,660,34
193,3,56,624,542,82
193,3,57,593,537,56
193,3,58,1094,600,494
193,3,59,686,756,-70
193,3,60,706,620,86
193,3,61,643,653,-10
193,3,62,820,657,163
193,3,63,710,747,-37
193,3,64,673,658,15
193,3,65,758,593,165
193,3,66,669,710,-41
193,3,67,679,600,79
193,3,68,661,575,86
193,3,69,775,654,121
193,3,70,750,621,129
193,3,71,1042,542,500
193,3,72,646,565,81
194,3,3,923,1065,-142
194,3,4,929,1053,-124
194,3,5,872,1196,-324
194,3,6,833,957,-124
194,3,7,850,789,61
194,3,8,877,975,-98
194,3,9,849,969,-120
194,3,10,827,980,-153
194,3,11,974,1024,-50
194,3,12,862,963,-101
194,3,13,910,963,-53
194,3,14,814,893,-79
194,3,15,799,995,-196
194,3,16,805,1135,-330
194,3,17,848,1099,-251
194,3,18,1141,1237,-96
194,3,19,853,1063,-210
194,3,20,821,961,-140
194,3,21,747,895,-148
194,3,22,761,893,-132
194,3,23,830,936,-106
194,3,24,798,965,-167
194,3,25,831,1020,-189
194,3,26,783,902,-119
194,3,27,857,945,-88
194,3,28,792,1025,-233
194,3,29,803,965,-162
194,3,30,808,908,-100
194,3,31,772,1054,-282
194,3,32,754,1014,-260
194,3,33,912,1007,-95
194,3,34,914,888,26
194,3,35,810,904,-94
194,3,36,794,965,-171
194,3,37,859,929,-70
194,3,38,787,864,-77
194,3,39,863,776,87
194,3,40,827,957,-130
194,3,41,758,798,-40
194,3,43,996,973,23
194,3,44,853,965,-112
194,3,45,776,949,-173
194,3,46,867,1038,-171
194,3,47,800,964,-164
194,3,48,778,781,-3
194,3,49,739,884,-145
194,3,50,767,996,-229
194,3,51,757,908,-151
194,3,52,772,805,-33
194,3,53,775,832,-57
194,3,54,759,856,-97
194,3,55,773,944,-171
194,3,56,1131,859,272
194,3,57,808,1052,-244
194,3,58,922,973,-51
194,3,59,743,916,-173
194,3,60,739,930,-191
194,3,61,771,829,-58
194,3,62,776,743,33
194,3,63,867,892,-25
194,3,64,830,920,-90
194,3,65,820,1058,-238
194,3,66,781,886,-105
194,3,67,756,955,-199
194,3,68,769,893,-124
194,3,69,779,961,-182
194,3,70,829,902,-73
194,3,71,843,923,-80
194,3,72,805,870,-65
195,2,1,1555,1872,-317
195,2,2,1488,1560,-72
195,2,3,1410,1423,-13
195,2,4,1425,1776,-351
195,2,5,1430,1552,-122
195,2,6,1426,1450,-24
195,2,7,1444,1481,-37
195,2,8,1489,1376,113
195,2,9,1510,1512,-2
195,2,10,1431,1437,-6
195,2,11,1387,1357,30
195,2,12,1422,1437,-15
195,2,14,1512,1798,-286
195,2,15,1510,1530,-20
195,2,16,1360,1423,-63
195,2,17,1454,1354,100
195,2,18,1385,1353,32
195,2,19,1435,1425,10
195,2,20,1400,1424,-24
195,2,21,1478,1410,68
195,2,22,1434,1292,142
195,2,23,1410,1607,-197
195,2,24,1409,1380,29
195,2,25,1569,1460,109
195,2,26,1400,1494,-94
195,2,27,1394,1402,-8
195,2,28,1428,1405,23
195,2,29,1340,1418,-78
195,2,30,1359,1278,81
195,2,31,1400,1375,25
195,2,32,1331,1705,-374
195,2,33,1427,1694,-267
195,2,34,1343,1440,-97
195,2,35,1331,1428,-97
195,2,36,1579,1332,247
195,2,37,1412,1431,-19
195,2,38,1355,1487,-132
195,2,39,1367,1389,-22
195,2,40,933,1532,-599
195,2,42,1576,1328,248
195,2,43,1350,1664,-314
195,2,44,1435,1430,5
195,2,46,1381,1371,10
195,2,47,1359,1382,-23
195,2,48,1330,1466,-136
195,2,49,856,905,-49
195,2,50,1318,1334,-16
195,2,52,1300,1394,-94
195,2,53,1367,1392,-25
195,2,54,1555,1408,147
195,2,55,1558,1430,128
195,2,56,1325,1218,107
195,2,57,1181,1424,-243
195,2,58,1404,1461,-57
195,2,60,1158,1353,-195
195,2,61,1341,1501,-160
195,2,62,1355,1570,-215
195,2,63,1307,1344,-37
195,2,64,1531,1357,174
195,2,65,1443,1447,-4
195,2,66,1331,1527,-196
195,2,67,1356,1380,-24
195,2,68,1373,1576,-203
195,2,69,1379,1565,-186
195,2,70,1331,1348,-17
195,2,71,1283,1336,-53
195,2,72,1098,992,106
196,3,1,1911,1190,721
196,3,2,1299,1133,166
196,3,3,1057,1218,-161
196,3,4,1170,795,375
196,3,5,1032,1140,-108
196,3,7,1002,1099,-97
196,3,8,767,930,-163
196,3,9,944,1221,-277
196,3,10,1149,1187,-38
196,3,11,952,1155,-203
196,3,12,1145,1326,-181
196,3,16,1025,1175,-150
196,3,17,1426,1246,180
197,3,1,936,1509,-573
197,3,2,942,1047,-105
197,3,3,982,775,207
197,3,4,860,762,98
197,3,5,994,826,168
197,3,6,978,950,28
197,3,7,854,704,150
197,3,8,831,715,116
197,3,9,892,787,105
197,3,10,842,743,99
197,3,11,906,774,132
197,3,12,828,700,128
197,3,13,907,626,281
197,3,14,887,722,165
197,3,15,835,664,171
197,3,16,744,713,31
197,3,17,790,646,144
197,3,18,864,744,120
197,3,19,835,594,241
197,3,20,834,650,184
197,3,21,760,758,2
197,3,22,879,633,246
197,3,23,875,677,198
197,3,24,972,707,265
197,3,25,1583,665,918
197,3,26,803,659,144
197,3,27,815,646,169
197,3,28,853,591,262
197,3,30,786,674,112
197,3,31,848,736,112
197,3,32,900,747,153
197,3,33,903,719,184
197,3,34,768,634,134
197,3,35,768,634,134
197,3,36,796,695,101
197,3,37,712,685,27
197,3,38,830,725,105
197,3,39,817,516,301
197,3,40,1142,864,278
197,3,41,812,686,126
197,3,42,901,686,215
197,3,43,772,638,134
197,3,44,772,788,-16
197,3,45,807,659,148
197,3,46,752,676,76
197,3,47,810,676,134
197,3,48,744,669,75
197,3,49,679,674,5
197,3,50,751,583,168
197,3,51,778,706,72
197,3,52,785,712,73
197,3,53,1159,694,465
197,3,54,842,718,124
197,3,56,849,697,152
197,3,57,813,649,164
197,3,58,680,691,-11
197,3,59,744,681,63
197,3,60,808,705,103
197,3,61,676,638,38
197,3,62,723,581,142
197,3,63,743,694,49
197,3,64,808,660,148
197,3,65,863,649,214
197,3,66,965,791,174
197,3,67,727,704,23
197,3,68,775,675,100
197,3,69,1026,662,364
197,3,70,685,631,54
197,3,71,720,680,40
197,3,72,804,766,38
198,1,1,882,1325,-443
198,1,2,851,988,-137
198,1,3,820,842,-22
198,1,4,873,784,89
198,1,5,1273,948,325
198,1,6,739,768,-29
198,1,7,958,767,191
198,1,8,951,858,93
198,1,9,1008,760,248
198,1,10,797,486,311
198,1,11,784,497,287
198,1,12,930,847,83
198,1,13,806,699,107
198,1,15,961,413,548
198,1,16,423,550,-127
198,1,17,691,583,108
198,1,18,880,761,119
198,1,19,877,506,371
198,1,20,830,823,7
198,1,21,949,674,275
198,1,22,708,242,466
198,1,24,773,518,255
198,1,25,853,363,490
198,1,26,611,343,268
198,1,27,767,420,347
198,1,28,660,9,651
198,1,29,770,32,738
198,1,30,852,71,781
198,1,31,827,115,712
198,1,33,846,121,725
198,1,34,901,416,485
198,1,35,681,185,496
198,1,37,907,325,582
198,1,38,955,125,830
198,1,39,946,2,944
198,1,40,958,67,891
198,1,41,809,26,783
198,1,42,784,168,616
198,1,43,765,107,658
198,1,44,697,71,626
198,1,45,638,127,511
198,1,46,904,174,730
198,1,47,973,499,474
198,1,48,772,375,397
198,1,49,804,456,348
198,1,50,822,319,503
198,1,51,1056,36,1020
198,1,52,916,433,483
198,1,53,663,517,146
198,1,55,1038,108,930
198,1,56,756,55,701
198,1,57,705,257,448
198,1,58,762,137,625
198,1,59,579,144,435
198,1,60,1191,269,922
198,1,61,638,204,434
198,1,62,594,878,-284
198,1,63,760,76,684
198,1,64,846,318,528
198,1,66,1086,426,660
198,1,67,851,694,157
198,1,68,812,181,631
198,1,69,812,46,766
198,1,70,827,821,6
198,1,71,778,596,182
199,2,1,669,998,-329
199,2,2,726,1228,-502
199,2,5,791,1055,-264
199,2,6,719,720,-1
199,2,7,769,664,105
199,2,8,747,1077,-330
199,2,9,1681,1128,553
199,2,10,1180,996,184
199,2,11,911,1072,-161
199,2,12,814,831,-17
199,2,13,765,661,104
199,2,14,930,970,-40
199,2,15,903,895,8
199,2,16,736,858,-122
199,2,17,1044,973,71
199,2,18,954,889,65
199,2,19,820,698,122
199,2,20,1011,1019,-8
199,2,21,797,907,-110
199,2,22,851,876,-25
199,2,23,1001,895,106
199,2,24,675,691,-16
199,2,25,716,899,-183
199,2,26,1029,1062,-33
199,2,27,1254,902,352
199,2,28,776,570,206
199,2,29,1135,1105,30
199,2,31,708,940,-232
199,2,32,757,1854,-1097
199,2,34,930,923,7
199,2,35,1616,665,951
199,2,36,722,633,89
199,2,38,785,1168,-383
199,2,39,866,1187,-321
199,2,40,890,1411,-521
199,2,41,889,971,-82
199,2,42,865,928,-63
199,2,43,1293,987,306
199,2,44,995,1051,-56
199,2,45,1379,995,384
199,2,46,974,1168,-194
199,2,47,925,949,-24
199,2,48,894,1287,-393
199,2,49,698,634,64
199,2,51,756,643,113
199,2,52,702,783,-81
199,2,53,700,650,50
199,2,54,715,691,24
199,2,55,716,622,94
199,2,56,980,662,318
199,2,57,723,653,70
199,2,59,723,614,109
199,2,60,749,750,-1
199,2,61,730,651,79
199,2,62,797,643,154
199,2,64,718,709,9
199,2,65,792,866,-74
199,2,66,622,976,-354
199,2,67,633,866,-233
199,2,68,711,784,-73
199,2,69,801,612,189
199,2,70,735,744,-9
199,2,71,838,831,7
199,2,72,751,783,-32
200,2,1,999,1481,-482
200,2,3,1069,1161,-92
200,2,4,937,1361,-424
200,2,5,1050,950,100
200,2,6,1332,991,341
200,2,7,1468,1112,356
200,2,8,1006,1046,-40
200,2,9,1442,1391,51
200,2,10,1006,1781,-775
200,2,11,1002,1211,-209
200,2,12,1064,923,141
200,2,13,1005,852,153
200,2,14,879,1129,-250
200,2,15,840,1170,-330
200,2,16,939,851,88
200,2,17,805,937,-132
200,2,18,987,916,71
200,2,19,911,903,8
200,2,20,1031,783,248
200,2,21,826,861,-35
200,2,22,807,1083,-276
200,2,23,962,1052,-90
200,2,24,937,1133,-196
200,2,25,850,979,-129
200,2,26,805,889,-84
200,2,27,809,1167,-358
200,2,28,970,1014,-44
200,2,29,905,870,35
200,2,30,880,860,20
200,2,31,953,859,94
200,2,32,888,772,116
200,2,33,828,871,-43
200,2,34,858,882,-24
200,2,35,863,975,-112
200,2,36,920,806,114
200,2,37,761,745,16
200,2,38,906,812,94
200,2,39,858,807,51
200,2,40,1069,1182,-113
200,2,41,1019,913,106
200,2,42,857,783,74
200,2,44,932,869,63
200,2,45,1227,933,294
200,2,46,884,717,167
200,2,47,935,837,98
200,2,48,878,1140,-262
200,2,49,901,1045,-144
200,2,50,914,786,128
200,2,51,1196,848,348
200,2,52,843,837,6
200,2,53,765,770,-5
200,2,54,774,756,18
200,2,55,841,852,-11
200,2,56,703,925,-222
200,2,57,832,867,-35
200,2,58,761,892,-131
200,2,59,721,792,-71
200,2,60,648,804,-156
200,2,61,823,912,-89
200,2,62,822,901,-79
200,2,63,1066,811,255
200,2,64,823,695,128
200,2,65,694,865,-171
200,2,66,647,565,82
200,2,67,784,552,232
200,2,68,922,770,152
200,2,69,700,678,22
200,2,70,853,748,105
200,2,71,688,813,-125
200,2,72,728,424,304
201,1,1,957,1258,-301
201,1,2,977,942,35
201,1,3,910,938,-28
201,1,4,869,800,69
201,1,5,752,787,-35
201,1,6,831,706,125
201,1,7,810,783,27
201,1,8,851,762,89
201,1,9,795,735,60
201,1,10,850,678,172
201,1,11,733,698,35
201,1,12,839,784,55
201,1,13,790,767,23
201,1,14,785,741,44
201,1,15,839,415,424
201,1,16,851,699,152
201,1,17,893,301,592
201,1,18,761,245,516
201,1,19,748,220,528
201,1,20,802,378,424
201,1,21,1002,505,497
201,1,22,798,469,329
201,1,23,875,247,628
201,1,24,904,254,650
201,1,25,680,294,386
201,1,26,799,501,298
201,1,27,809,303,506
201,1,28,799,467,332
201,1,29,895,305,590
201,1,30,675,252,423
201,1,31,729,370,359
201,1,32,790,249,541
201,1,33,836,189,647
201,1,34,821,647,174
201,1,35,802,1,801
201,1,36,741,154,587
201,1,37,799,241,558
201,1,38,796,330,466
201,1,39,529,651,-122
201,1,40,837,373,464
201,1,41,828,302,526
201,1,42,1078,397,681
201,1,43,777,99,678
201,1,44,812,342,470
201,1,45,854,384,470
201,1,46,790,793,-3
201,1,47,755,372,383
201,1,48,781,742,39
201,1,49,748,293,455
201,1,50,721,341,380
201,1,51,771,279,492
201,1,52,884,506,378
201,1,53,816,365,451
201,1,54,886,777,109
201,1,55,826,279,547
201,1,57,869,351,518
201,1,58,700,85,615
201,1,59,736,340,396
201,1,60,900,617,283
201,1,61,625,97,528
201,1,62,761,347,414
201,1,63,713,273,440
201,1,64,506,411,95
201,1,65,862,424,438
201,1,66,824,644,180
201,1,67,685,320,365
201,1,68,807,291,516
201,1,69,802,358,444
201,1,70,757,416,341
201,1,71,656,173,483
201,1,72,739,324,415
202,2,1,1018,1562,-544
202,2,2,1000,1438,-438
202,2,3,1005,1113,-108
202,2,4,975,1115,-140
202,2,5,1114,1238,-124
202,2,6,979,1164,-185
202,2,7,1154,1163,-9
202,2,8,1016,1025,-9
202,2,9,1000,1144,-144
202,2,10,1133,1135,-2
202,2,11,1037,1097,-60
202,2,12,968,1116,-148
202,2,13,1040,1012,28
202,2,14,898,1085,-187
202,2,15,895,984,-89
202,2,16,1006,1046,-40
202,2,17,845,1016,-171
202,2,18,991,982,9
202,2,19,1052,984,68
202,2,20,1022,1097,-75
202,2,21,1095,1027,68
202,2,22,962,974,-12
202,2,23,1022,990,32
202,2,24,1037,1115,-78
202,2,25,1032,939,93
202,2,26,964,1325,-361
202,2,27,994,1583,-589
202,2,28,925,1000,-75
202,2,29,1080,1036,44
202,2,30,928,876,52
202,2,31,639,975,-336
202,2,32,1137,992,145
202,2,33,1018,910,108
202,2,34,1028,1106,-78
202,2,35,929,975,-46
202,2,36,958,971,-13
202,2,37,963,963,0
202,2,38,962,922,40
202,2,39,921,869,52
202,2,40,1538,928,610
202,2,41,851,977,-126
202,2,42,870,915,-45
202,2,43,835,1036,-201
202,2,44,930,896,34
202,2,45,627,967,-340
202,2,46,1069,995,74
202,2,47,915,1061,-146
202,2,48,936,1071,-135
202,2,49,922,960,-38
202,2,50,908,1070,-162
202,2,51,945,941,4
202,2,52,872,1078,-206
202,2,53,1114,1105,9
202,2,54,976,999,-23
202,2,55,962,954,8
202,2,56,953,892,61
202,2,57,969,1116,-147
202,2,58,900,937,-37
202,2,59,947,936,11
202,2,60,897,889,8
202,2,61,959,1003,-44
202,2,62,879,968,-89
202,2,63,847,874,-27
202,2,64,940,973,-33
202,2,65,896,890,6
202,2,66,830,993,-163
202,2,67,914,1124,-210
202,2,68,933,947,-14
202,2,69,1116,981,135
202,2,70,764,941,-177
202,2,71,927,1002,-75
202,2,72,949,942,7
203,2,1,1079,1354,-275
203,2,3,1202,1149,53
203,2,4,1003,1175,-172
203,2,5,1088,1054,34
203,2,6,1025,1094,-69
203,2,7,999,1145,-146
203,2,8,988,1098,-110
203,2,9,932,1064,-132
203,2,11,1045,1008,37
203,2,12,1262,1025,237
203,2,13,1211,1104,107
203,2,14,983,1103,-120
203,2,15,1208,1513,-305
203,2,16,880,1025,-145
203,2,17,879,1142,-263
203,2,18,1329,1197,132
203,2,19,1142,1249,-107
203,2,20,1343,1199,144
203,2,21,1196,1269,-73
203,2,22,1186,1169,17
203,2,23,1161,1171,-10
203,2,24,936,979,-43
203,2,26,1018,1033,-15
203,2,27,926,1009,-83
203,2,28,893,1018,-125
203,2,29,1160,1043,117
203,2,30,962,1050,-88
203,2,31,988,1101,-113
203,2,32,986,899,87
203,2,33,921,913,8
203,2,34,965,1062,-97
203,2,35,960,1036,-76
203,2,36,913,1050,-137
203,2,37,1184,1018,166
203,2,38,1019,915,104
203,2,39,931,1038,-107
203,2,40,1076,1075,1
203,2,41,928,1040,-112
203,2,42,899,1064,-165
203,2,43,1022,975,47
203,2,44,1094,936,158
203,2,45,1074,1133,-59
203,2,46,892,1138,-246
203,2,48,1247,1159,88
203,2,49,1072,988,84
203,2,50,962,962,0
203,2,51,986,1137,-151
203,2,52,962,1153,-191
203,2,53,1171,1427,-256
203,2,54,1050,1322,-272
203,2,55,1023,1303,-280
203,2,56,1007,1208,-201
203,2,57,1051,1523,-472
203,2,58,1051,1323,-272
203,2,59,1232,1342,-110
203,2,60,1083,1265,-182
203,2,61,942,1102,-160
203,2,63,1024,1615,-591
203,2,64,946,1131,-185
203,2,65,1018,1097,-79
203,2,66,983,1180,-197
203,2,67,913,1139,-226
203,2,68,1010,986,24
203,2,69,926,974,-48
203,2,70,973,996,-23
203,2,71,906,1299,-393
203,2,72,912,921,-9
204,2,1,1270,1291,-21
204,2,3,1096,1497,-401
204,2,5,1034,1267,-233
204,2,6,1002,996,6
204,2,7,963,1120,-157
204,2,8,1064,1224,-160
204,2,9,968,1127,-159
204,2,10,890,1061,-171
204,2,11,1139,1373,-234
204,2,12,1097,1163,-66
204,2,14,823,998,-175
204,2,15,1015,1189,-174
204,2,16,975,934,41
204,2,17,965,999,-34
204,2,18,923,936,-13
204,2,19,904,845,59
204,2,21,905,856,49
204,2,23,895,938,-43
204,2,25,892,947,-55
204,2,26,982,998,-16
204,2,27,829,834,-5
204,2,28,854,1253,-399
204,2,29,1018,1137,-119
204,2,30,1069,1027,42
204,2,31,997,1111,-114
204,2,32,911,1126,-215
204,2,34,1010,517,493
204,2,35,1038,275,763
204,2,37,1154,1135,19
204,2,38,837,338,499
204,2,39,867,378,489
204,2,40,896,262,634
204,2,41,780,37,743
204,2,42,981,106,875
204,2,43,799,141,658
204,2,44,860,114,746
204,2,45,964,5,959
204,2,46,844,90,754
204,2,47,842,57,785
204,2,48,850,206,644
204,2,49,950,105,845
204,2,50,946,119,827
204,2,51,900,338,562
204,2,52,1044,210,834
204,2,53,868,208,660
204,2,54,922,201,721
204,2,55,882,394,488
204,2,56,1105,178,927
204,2,57,813,90,723
204,2,58,750,19,731
204,2,59,888,23,865
204,2,60,905,3,902
204,2,61,1030,11,1019
204,2,62,818,5,813
204,2,63,849,89,760
204,2,64,766,6,760
204,2,65,924,3,921
204,2,66,832,26,806
204,2,67,899,11,888
204,2,68,894,2,892
204,2,69,1535,315,1220
204,2,70,916,10,906
204,2,71,786,29,757
204,2,72,939,183,756
205,1,1,1141,1041,100
205,1,2,821,936,-115
205,1,3,1152,845,307
205,1,4,810,871,-61
205,1,5,800,958,-158
205,1,6,810,719,91
205,1,7,780,743,37
205,1,8,779,791,-12
205,1,9,774,752,22
205,1,10,777,639,138
205,1,11,827,736,91
205,1,12,744,725,19
205,1,13,819,663,156
205,1,14,797,419,378
205,1,15,785,765,20
205,1,16,766,500,266
205,1,17,763,448,315
205,1,18,739,496,243
205,1,19,795,383,412
205,1,20,792,454,338
205,1,21,668,321,347
205,1,22,731,456,275
205,1,23,780,344,436
205,1,24,752,420,332
205,1,25,825,405,420
205,1,26,698,344,354
205,1,27,764,322,442
205,1,28,726,371,355
205,1,29,722,318,404
205,1,30,485,273,212
205,1,31,747,480,267
205,1,32,713,398,315
205,1,33,730,335,395
205,1,35,809,421,388
205,1,36,706,351,355
205,1,37,715,327,388
205,1,38,673,501,172
205,1,39,693,417,276
205,1,40,716,297,419
205,1,41,732,273,459
205,1,42,686,396,290
205,1,43,899,343,556
205,1,44,715,336,379
205,1,45,738,358,380
205,1,46,643,121,522
205,1,47,793,437,356
205,1,48,709,282,427
205,1,49,525,267,258
205,1,50,692,408,284
205,1,51,624,348,276
205,1,52,633,350,283
205,1,53,740,329,411
205,1,54,698,408,290
205,1,55,697,164,533
205,1,56,673,253,420
205,1,57,718,92,626
205,1,58,742,162,580
205,1,59,693,57,636
205,1,61,709,43,666
205,1,62,673,493,180
205,1,63,721,149,572
205,1,64,730,302,428
205,1,65,755,271,484
205,1,66,656,69,587
205,1,67,692,152,540
205,1,68,660,409,251
205,1,69,755,110,645
205,1,71,730,39,691
205,1,72,569,22,547
206,2,1,867,941,-74
206,2,2,774,889,-115
206,2,3,789,774,15
206,2,4,757,767,-10
206,2,5,716,934,-218
206,2,7,747,703,44
206,2,8,715,622,93
206,2,10,799,754,45
206,2,11,678,671,7
206,2,12,810,995,-185
206,2,13,1149,806,343
206,2,14,726,742,-16
206,2,15,817,778,39
206,2,16,783,762,21
206,2,17,724,645,79
206,2,18,828,935,-107
206,2,19,745,819,-74
206,2,20,735,809,-74
206,2,21,734,743,-9
206,2,22,676,782,-106
206,2,23,786,781,5
206,2,24,745,820,-75
206,2,25,676,685,-9
206,2,26,826,756,70
206,2,27,730,756,-26
206,2,28,954,694,260
206,2,29,730,797,-67
206,2,31,729,754,-25
206,2,32,704,808,-104
206,2,33,754,732,22
206,2,34,643,749,-106
206,2,36,787,996,-209
206,2,37,729,900,-171
206,2,38,850,1141,-291
206,2,39,871,769,102
206,2,40,792,739,53
206,2,41,689,692,-3
206,2,42,746,747,-1
206,2,43,617,668,-51
206,2,44,780,743,37
206,2,48,723,1045,-322
206,2,49,573,870,-297
206,2,50,688,698,-10
206,2,51,685,1167,-482
206,2,52,684,762,-78
206,2,53,851,892,-41
206,2,54,695,659,36
206,2,55,688,738,-50
206,2,56,734,648,86
206,2,57,718,639,79
206,2,58,719,666,53
206,2,59,773,736,37
206,2,60,796,726,70
206,2,61,1197,631,566
206,2,62,708,646,62
206,2,63,675,787,-112
206,2,64,732,902,-170
206,2,65,876,775,101
206,2,66,723,760,-37
206,2,67,729,715,14
206,2,68,735,665,70
206,2,69,733,894,-161
206,2,70,681,1147,-466
206,2,71,782,851,-69
207,2,1,955,1164,-209
207,2,2,1099,1288,-189
207,2,4,1035,1021,14
207,2,8,994,1017,-23
207,2,9,952,837,115
207,2,10,928,1016,-88
207,2,12,969,844,125
207,2,13,1018,966,52
207,2,14,1054,976,78
207,2,15,898,1220,-322
207,2,16,1064,1100,-36
207,2,17,946,857,89
207,2,18,1072,1055,17
207,2,19,1097,954,143
207,2,20,1004,1232,-228
207,2,21,1014,1008,6
207,2,22,925,1012,-87
207,2,23,1110,1010,100
207,2,24,1093,936,157
207,2,25,1124,936,188
207,2,26,951,999,-48
207,2,27,985,922,63
207,2,28,960,936,24
207,2,29,925,872,53
207,2,30,1033,1035,-2
207,2,31,1023,971,52
207,2,32,854,972,-118
207,2,33,888,969,-81
207,2,34,900,961,-61
207,2,35,1020,939,81
207,2,36,924,945,-21
207,2,37,934,928,6
207,2,38,1122,963,159
207,2,39,961,1032,-71
207,2,40,876,930,-54
207,2,41,1026,976,50
207,2,42,1240,956,284
207,2,43,934,893,41
207,2,44,940,1096,-156
207,2,45,931,971,-40
207,2,46,1008,1030,-22
207,2,47,911,1040,-129
207,2,48,856,913,-57
207,2,49,1012,923,89
207,2,50,1022,943,79
207,2,51,820,999,-179
207,2,52,836,928,-92
207,2,53,956,942,14
207,2,54,861,921,-60
207,2,55,919,920,-1
207,2,56,988,1020,-32
207,2,57,896,900,-4
207,2,58,942,865,77
207,2,59,853,951,-98
207,2,60,840,926,-86
207,2,61,1084,1204,-120
207,2,62,943,880,63
207,2,64,970,898,72
207,2,65,971,1000,-29
207,2,66,980,697,283
207,2,67,1045,680,365
207,2,68,1093,461,632
207,2,69,938,599,339
207,2,70,1106,280,826
207,2,71,934,778,156
207,2,72,1456,12,1444
208,1,1,1031,1572,-541
208,1,2,952,1140,-188
208,1,3,913,1232,-319
208,1,4,891,1244,-353
208,1,5,922,1276,-354
208,1,6,911,1294,-383
208,1,7,849,1032,-183
208,1,8,1043,1327,-284
208,1,9,897,1061,-164
208,1,10,900,601,299
208,1,11,884,940,-56
208,1,12,837,952,-115
208,1,13,870,1369,-499
208,1,14,830,468,362
208,1,15,959,562,397
208,1,16,933,607,326
208,1,20,781,832,-51
208,1,21,730,949,-219
208,1,22,736,161,575
208,1,24,823,408,415
208,1,28,180,161,19
208,1,30,853,1523,-670
208,1,31,801,839,-38
208,1,33,1013,1317,-304
208,1,34,1469,1062,407
208,1,35,1165,104,1061
208,1,36,1096,561,535
208,1,38,1142,1045,97
208,1,39,1184,1328,-144
208,1,40,1257,184,1073
208,1,42,1287,1257,30
208,1,44,1303,219,1084
208,1,45,1078,1244,-166
208,1,46,1012,1092,-80
208,1,47,1296,1267,29
208,1,48,1224,1368,-144
208,1,49,1457,220,1237
208,1,50,1043,963,80
208,1,51,809,10,799
208,1,54,917,1137,-220
208,1,55,918,1198,-280
208,1,56,1646,1262,384
208,1,59,970,200,770
208,1,61,1102,83,1019
208,1,63,924,370,554
208,1,64,857,1222,-365
208,1,65,979,460,519
208,1,66,805,1088,-283
208,1,67,852,979,-127
208,1,68,888,234,654
208,1,69,780,302,478
208,1,70,860,237,623
208,1,71,773,306,467
209,1,1,820,1018,-198
209,1,2,792,846,-54
209,1,3,842,909,-67
209,1,4,822,753,69
209,1,5,994,915,79
209,1,7,969,729,240
209,1,8,885,1102,-217
209,1,9,856,570,286
209,1,10,824,790,34
209,1,11,743,929,-186
209,1,12,925,924,1
209,1,13,733,718,15
209,1,14,619,494,125
209,1,15,855,376,479
209,1,16,584,357,227
209,1,17,738,314,424
209,1,18,744,278,466
209,1,19,901,370,531
209,1,20,707,338,369
209,1,21,577,364,213
209,1,22,842,551,291
209,1,23,717,565,152
209,1,24,940,922,18
209,1,25,468,322,146
209,1,26,933,271,662
209,1,27,543,297,246
209,1,28,826,397,429
209,1,29,780,435,345
209,1,30,761,622,139
209,1,31,816,395,421
209,1,32,798,440,358
209,1,33,730,500,230
209,1,34,621,542,79
209,1,35,875,338,537
209,1,37,766,95,671
209,1,38,608,228,380
209,1,39,796,413,383
209,1,40,894,310,584
209,1,41,846,485,361
209,1,42,736,50,686
209,1,44,838,281,557
209,1,45,689,343,346
209,1,46,704,327,377
209,1,47,777,701,76
209,1,48,843,493,350
209,1,49,760,125,635
209,1,50,793,161,632
209,1,51,1780,169,1611
209,1,52,681,177,504
209,1,53,793,227,566
209,1,54,798,335,463
209,1,55,833,36,797
209,1,56,740,220,520
209,1,57,820,238,582
209,1,58,821,289,532
209,1,59,852,423,429
209,1,60,957,216,741
209,1,61,538,150,388
209,1,62,951,83,868
209,1,63,683,320,363
209,1,64,903,118,785
209,1,65,787,163,624
209,1,66,755,200,555
209,1,67,900,41,859
209,1,68,737,136,601
209,1,70,710,221,489
209,1,71,776,226,550
209,1,72,845,293,552
210,2,1,958,1148,-190
210,2,2,1081,1161,-80
210,2,3,865,900,-35
210,2,4,956,957,-1
210,2,5,986,856,130
210,2,6,930,972,-42
210,2,7,934,857,77
210,2,8,951,991,-40
210,2,9,997,938,59
210,2,10,884,978,-94
210,2,11,913,958,-45
210,2,12,950,930,20
210,2,13,907,819,88
210,2,14,912,798,114
210,2,15,977,818,159
210,2,16,845,848,-3
210,2,17,778,892,-114
210,2,18,983,812,171
210,2,19,903,781,122
210,2,20,846,790,56
210,2,21,855,743,112
210,2,22,899,835,64
210,2,23,879,855,24
210,2,24,882,755,127
210,2,25,807,703,104
210,2,26,796,691,105
210,2,27,837,691,146
210,2,28,866,772,94
210,2,29,830,691,139
210,2,30,1004,703,301
210,2,31,1084,1203,-119
210,2,33,1355,1020,335
210,2,34,814,697,117
210,2,35,894,851,43
210,2,36,899,785,114
210,2,37,797,689,108
210,2,38,948,684,264
210,2,39,785,828,-43
210,2,41,978,704,274
210,2,42,829,759,70
210,2,43,866,650,216
210,2,44,853,818,35
210,2,45,917,757,160
210,2,46,868,782,86
210,2,47,878,761,117
210,2,48,916,885,31
210,2,49,892,703,189
210,2,50,763,746,17
210,2,51,883,655,228
210,2,52,817,708,109
210,2,53,991,667,324
210,2,54,813,694,119
210,2,55,892,757,135
210,2,56,897,769,128
210,2,57,964,800,164
210,2,58,879,710,169
210,2,59,944,784,160
210,2,60,880,747,133
210,2,61,817,765,52
210,2,62,749,799,-50
210,2,63,848,685,163
210,2,64,885,736,149
210,2,65,854,732,122
210,2,66,902,713,189
210,2,67,813,725,88
210,2,68,877,641,236
210,2,69,859,689,170
210,2,70,849,729,120
210,2,71,844,781,63
210,2,72,874,899,-25
211,3,1,976,1243,-267
211,3,2,873,971,-98
211,3,4,1106,988,118
211,3,5,948,1114,-166
211,3,6,922,996,-74
211,3,7,954,1035,-81
211,3,8,1048,920,128
211,3,9,1030,924,106
211,3,10,827,1008,-181
211,3,11,886,925,-39
211,3,12,1025,878,147
211,3,13,1262,888,374
211,3,14,892,799,93
211,3,15,828,805,23
211,3,16,934,760,174
211,3,17,1018,861,157
211,3,18,820,922,-102
211,3,19,798,752,46
211,3,20,923,959,-36
211,3,21,783,1061,-278
211,3,22,836,844,-8
211,3,23,859,857,2
211,3,24,853,926,-73
211,3,25,773,866,-93
211,3,26,742,909,-167
211,3,27,871,1028,-157
211,3,28,962,966,-4
211,3,29,986,955,31
211,3,30,859,908,-49
211,3,31,856,1010,-154
211,3,32,848,994,-146
211,3,33,1174,929,245
211,3,34,925,916,9
211,3,35,787,1005,-218
211,3,36,872,930,-58
211,3,37,844,926,-82
211,3,38,854,799,55
211,3,39,1018,729,289
211,3,40,867,1262,-395
211,3,41,1085,1178,-93
211,3,42,881,1175,-294
211,3,43,1013,947,66
211,3,44,826,877,-51
211,3,45,968,1133,-165
211,3,46,830,879,-49
211,3,47,857,859,-2
211,3,48,827,1189,-362
211,3,49,874,1015,-141
211,3,50,1110,788,322
211,3,51,1227,911,316
211,3,52,789,698,91
211,3,54,714,772,-58
211,3,55,726,824,-98
211,3,56,899,693,206
211,3,57,818,722,96
211,3,58,809,1076,-267
211,3,59,987,921,66
211,3,60,995,779,216
211,3,61,1701,731,970
211,3,62,938,1050,-112
211,3,63,863,1740,-877
211,3,64,1273,1050,223
211,3,65,976,961,15
211,3,66,867,806,61
211,3,67,841,988,-147
211,3,68,890,967,-77
211,3,69,898,852,46
211,3,70,901,894,7
211,3,71,879,776,103
211,3,72,830,953,-123
212,1,1,1134,1217,-83
212,1,2,967,1147,-180
212,1,3,1139,1034,105
212,1,4,965,1259,-294
212,1,5,963,871,92
212,1,6,1098,1034,64
212,1,7,1076,965,111
212,1,8,1190,902,288
212,1,9,1097,1040,57
212,1,10,1847,1261,586
212,1,11,904,805,99
212,1,13,931,925,6
212,1,14,902,733,169
212,1,15,918,862,56
212,1,16,878,848,30
212,1,17,991,799,192
212,1,18,917,652,265
212,1,19,1249,1011,238
212,1,20,1010,1230,-220
212,1,21,914,719,195
212,1,22,900,775,125
212,1,23,1033,879,154
212,1,24,863,689,174
212,1,25,1322,980,342
212,1,26,869,774,95
212,1,27,1083,995,88
212,1,28,1020,872,148
212,1,29,1130,971,159
212,1,30,1012,1033,-21
212,1,31,1262,1144,118
212,1,32,1134,1128,6
212,1,33,1171,1120,51
212,1,34,899,1568,-669
212,1,35,1124,1360,-236
212,1,36,1161,949,212
212,1,37,1017,1100,-83
212,1,38,883,769,114
212,1,39,1037,749,288
212,1,40,1000,689,311
212,1,42,927,735,192
212,1,43,934,995,-61
212,1,44,999,869,130
212,1,45,1082,943,139
212,1,46,1136,732,404
212,1,47,959,901,58
212,1,48,1077,828,249
212,1,49,1223,1135,88
212,1,50,842,1102,-260
212,1,51,1249,1024,225
212,1,52,706,853,-147
212,1,53,1109,746,363
212,1,54,685,690,-5
212,1,55,973,846,127
212,1,57,1094,716,378
212,1,58,1112,702,410
212,1,60,799,891,-92
212,1,61,1076,830,246
212,1,62,961,962,-1
212,1,63,1132,1033,99
212,1,64,814,738,76
212,1,65,916,768,148
212,1,66,996,684,312
212,1,67,1251,888,363
212,1,68,1107,896,211
212,1,69,1097,827,270
212,1,70,1209,821,388
212,1,72,947,964,-17
213,3,1,826,934,-108
213,3,3,807,837,-30
213,3,4,868,759,109
213,3,5,750,753,-3
213,3,6,882,879,3
213,3,7,799,738,61
213,3,8,925,639,286
213,3,9,718,735,-17
213,3,10,800,704,96
213,3,11,780,878,-98
213,3,12,790,839,-49
213,3,13,734,765,-31
213,3,14,715,806,-91
213,3,15,786,1055,-269
213,3,16,684,661,23
213,3,17,897,959,-62
213,3,18,821,718,103
213,3,19,758,805,-47
213,3,20,791,714,77
213,3,22,715,636,79
213,3,23,765,714,51
213,3,24,905,762,143
213,3,25,802,664,138
213,3,26,728,1175,-447
213,3,27,1069,711,358
213,3,28,801,805,-4
213,3,29,887,621,266
213,3,30,729,1089,-360
213,3,31,693,618,75
213,3,32,779,769,10
213,3,34,728,695,33
213,3,35,643,768,-125
213,3,36,967,1499,-532
213,3,37,672,686,-14
213,3,38,708,658,50
213,3,39,800,844,-44
213,3,40,738,757,-19
213,3,41,980,773,207
213,3,42,686,839,-153
213,3,43,746,953,-207
213,3,44,798,793,5
213,3,45,709,768,-59
213,3,46,776,688,88
213,3,47,662,753,-91
213,3,48,766,628,138
213,3,49,751,684,67
213,3,50,741,606,135
213,3,51,828,696,132
213,3,52,748,638,110
213,3,53,827,681,146
213,3,54,707,1075,-368
213,3,55,776,835,-59
213,3,56,694,706,-12
213,3,57,688,653,35
213,3,58,725,622,103
213,3,59,781,730,51
213,3,61,857,712,145
213,3,62,735,803,-68
213,3,63,654,774,-120
213,3,64,781,789,-8
213,3,65,699,730,-31
213,3,66,638,1149,-511
213,3,67,695,616,79
213,3,68,705,704,1
213,3,69,673,833,-160
213,3,70,677,669,8
213,3,71,660,723,-63
213,3,72,674,739,-65
214,2,1,1172,1179,-7
214,2,2,1075,1183,-108
214,2,3,1008,846,162
214,2,4,1062,749,313
214,2,5,908,941,-33
214,2,6,882,778,104
214,2,7,1001,698,303
214,2,8,968,695,273
214,2,9,963,1104,-141
214,2,10,1092,843,249
214,2,11,942,1000,-58
214,2,12,983,791,192
214,2,13,994,771,223
214,2,14,901,748,153
214,2,15,1004,836,168
214,2,16,1035,628,407
214,2,17,1017,810,207
214,2,18,913,754,159
214,2,19,913,768,145
214,2,20,892,764,128
214,2,21,930,705,225
214,2,22,964,786,178
214,2,23,904,759,145
214,2,24,948,708,240
214,2,25,959,744,215
214,2,26,903,753,150
214,2,27,954,754,200
214,2,28,910,821,89
214,2,29,1053,787,266
214,2,30,893,836,57
214,2,31,936,666,270
214,2,32,990,695,295
214,2,33,977,649,328
214,2,34,889,680,209
214,2,35,928,776,152
214,2,36,877,910,-33
214,2,37,884,740,144
214,2,38,986,730,256
214,2,39,934,870,64
214,2,40,915,747,168
214,2,41,921,648,273
214,2,42,896,726,170
214,2,43,868,793,75
214,2,44,837,748,89
214,2,45,954,810,144
214,2,46,976,735,241
214,2,47,953,736,217
214,2,48,943,648,295
214,2,49,1042,650,392
214,2,50,906,666,240
214,2,51,915,713,202
214,2,52,880,646,234
214,2,53,906,643,263
214,2,54,1093,950,143
214,2,55,1197,901,296
214,2,56,969,735,234
214,2,57,937,641,296
214,2,58,1008,704,304
214,2,59,941,669,272
214,2,60,1004,670,334
214,2,61,902,751,151
214,2,62,861,640,221
214,2,63,950,655,295
214,2,64,902,750,152
214,2,65,904,744,160
214,2,66,895,951,-56
214,2,67,839,688,151
214,2,68,939,587,352
214,2,69,970,699,271
214,2,70,934,677,257
214,2,71,982,631,351
214,2,72,1054,637,417
215,3,1,1049,1428,-379
215,3,3,1017,1900,-883
215,3,4,1266,1377,-111
215,3,5,1163,1118,45
215,3,6,914,1244,-330
215,3,7,1029,1110,-81
215,3,8,1003,1081,-78
215,3,9,866,1101,-235
215,3,10,1029,1220,-191
215,3,11,912,1090,-178
215,3,12,1118,1147,-29
215,3,13,950,1146,-196
215,3,14,1160,1004,156
215,3,15,979,1052,-73
215,3,16,1160,1155,5
215,3,17,907,1018,-111
215,3,18,1021,1248,-227
215,3,19,1094,983,111
215,3,20,1058,1286,-228
215,3,21,1100,1191,-91
215,3,22,1031,1201,-170
215,3,23,1114,1002,112
215,3,25,1168,999,169
215,3,26,896,1034,-138
215,3,27,1015,1075,-60
215,3,28,930,1412,-482
215,3,29,1156,1070,86
215,3,30,944,1264,-320
215,3,31,839,986,-147
215,3,32,815,1054,-239
215,3,33,891,1241,-350
215,3,34,1016,1381,-365
215,3,35,920,1375,-455
215,3,36,1143,1228,-85
215,3,37,1029,962,67
215,3,38,1061,1091,-30
215,3,39,939,1086,-147
215,3,40,927,1016,-89
215,3,41,1188,1150,38
215,3,42,933,1045,-112
215,3,43,998,1088,-90
215,3,44,1010,1146,-136
215,3,45,954,1613,-659
215,3,47,1416,1242,174
215,3,49,1001,1745,-744
215,3,50,1000,1427,-427
215,3,51,774,1217,-443
215,3,52,930,968,-38
215,3,53,901,1095,-194
215,3,54,963,1084,-121
215,3,55,949,1120,-171
215,3,56,1627,1226,401
215,3,57,1144,969,175
215,3,58,987,1110,-123
215,3,59,1308,1151,157
215,3,61,982,1049,-67
215,3,63,943,1167,-224
215,3,64,909,1094,-185
215,3,65,1106,1417,-311
215,3,66,1050,1164,-114
215,3,67,912,1073,-161
215,3,68,1075,1038,37
215,3,69,1029,1232,-203
215,3,70,907,1030,-123
215,3,71,1003,1118,-115
215,3,72,973,1303,-330
216,3,1,876,1280,-404
216,3,3,962,729,233
216,3,4,938,873,65
216,3,5,905,839,66
216,3,6,897,1108,-211
216,3,7,762,1118,-356
216,3,8,775,935,-160
216,3,9,845,689,156
216,3,10,716,756,-40
216,3,11,723,809,-86
216,3,12,893,738,155
216,3,13,973,746,227
216,3,14,783,652,131
216,3,15,861,892,-31
216,3,16,799,763,36
216,3,17,774,1424,-650
216,3,18,776,820,-44
216,3,19,907,696,211
216,3,20,722,677,45
216,3,21,801,692,109
216,3,22,822,743,79
216,3,23,870,665,205
216,3,24,796,765,31
216,3,25,778,793,-15
216,3,26,881,1248,-367
216,3,27,651,662,-11
216,3,28,752,785,-33
216,3,29,813,688,125
216,3,30,741,853,-112
216,3,31,743,690,53
216,3,32,784,801,-17
216,3,33,851,731,120
216,3,34,758,721,37
216,3,35,765,787,-22
216,3,36,707,665,42
216,3,37,676,653,23
216,3,39,650,766,-116
216,3,40,764,539,225
216,3,41,665,672,-7
216,3,42,671,797,-126
216,3,43,764,622,142
216,3,44,791,680,111
216,3,46,695,742,-47
216,3,47,788,630,158
216,3,48,885,687,198
216,3,49,687,666,21
216,3,50,793,873,-80
216,3,51,932,713,219
216,3,52,915,674,241
216,3,53,1017,713,304
216,3,54,687,887,-200
216,3,55,1127,778,349
216,3,56,1133,989,144
216,3,57,847,714,133
216,3,58,846,929,-83
216,3,59,851,748,103
216,3,61,830,714,116
216,3,62,924,1017,-93
216,3,63,802,805,-3
216,3,64,1049,737,312
216,3,65,1015,694,321
216,3,66,630,683,-53
216,3,67,728,643,85
216,3,68,779,698,81
216,3,69,832,754,78
216,3,70,756,740,16
216,3,71,776,687,89
216,3,72,946,745,201
217,3,1,866,890,-24
217,3,2,831,625,206
217,3,3,851,927,-76
217,3,4,781,791,-10
217,3,5,812,746,66
217,3,6,803,672,131
217,3,7,891,714,177
217,3,8,769,696,73
217,3,9,787,605,182
217,3,10,818,709,109
217,3,11,753,669,84
217,3,12,864,558,306
217,3,13,759,766,-7
217,3,14,700,1040,-340
217,3,15,966,1179,-213
217,3,16,703,657,46
217,3,17,816,833,-17
217,3,18,860,704,156
217,3,19,814,754,60
217,3,20,712,672,40
217,3,21,740,754,-14
217,3,22,702,1030,-328
217,3,23,782,670,112
217,3,24,624,389,235
217,3,25,715,352,363
217,3,26,763,325,438
217,3,27,625,560,65
217,3,28,720,1027,-307
217,3,29,935,440,495
217,3,30,676,612,64
217,3,31,701,545,156
217,3,32,797,731,66
217,3,33,816,412,404
217,3,34,790,596,194
217,3,35,940,603,337
217,3,36,872,797,75
217,3,37,770,577,193
217,3,38,735,772,-37
217,3,39,802,613,189
217,3,41,1024,431,593
217,3,42,769,409,360
217,3,43,821,426,395
217,3,44,788,395,393
217,3,45,832,250,582
217,3,46,697,427,270
217,3,47,704,381,323
217,3,48,979,363,616
217,3,49,728,455,273
217,3,50,651,357,294
217,3,51,848,402,446
217,3,52,876,424,452
217,3,53,811,539,272
217,3,54,809,435,374
217,3,55,832,423,409
217,3,56,828,338,490
217,3,57,673,578,95
217,3,58,740,866,-126
217,3,59,764,527,237
217,3,60,673,404,269
217,3,61,752,427,325
217,3,62,689,392,297
217,3,63,714,371,343
217,3,64,797,372,425
217,3,65,440,343,97
217,3,66,693,751,-58
217,3,67,1162,367,795
217,3,68,676,435,241
217,3,69,730,695,35
217,3,70,783,781,2
217,3,71,721,650,71
217,3,72,717,342,375
218,3,1,1113,1059,54
218,3,2,923,986,-63
218,3,3,986,928,58
218,3,4,904,951,-47
218,3,5,848,953,-105
218,3,6,885,969,-84
218,3,7,860,945,-85
218,3,8,861,1061,-200
218,3,9,833,809,24
218,3,10,820,946,-126
218,3,11,777,767,10
218,3,12,790,905,-115
218,3,13,844,893,-49
218,3,14,758,702,56
218,3,15,844,811,33
218,3,16,791,889,-98
218,3,17,797,866,-69
218,3,18,832,863,-31
218,3,19,846,885,-39
218,3,20,887,849,38
218,3,21,747,836,-89
218,3,22,784,989,-205
218,3,23,833,843,-10
218,3,24,876,826,50
218,3,25,704,908,-204
218,3,26,734,788,-54
218,3,27,857,837,20
218,3,28,834,893,-59
218,3,29,790,827,-37
218,3,30,948,913,35
218,3,31,828,934,-106
218,3,32,860,844,16
218,3,34,820,918,-98
218,3,35,898,800,98
218,3,36,869,1118,-249
218,3,37,1141,731,410
218,3,38,821,923,-102
218,3,39,728,870,-142
218,3,40,887,855,32
218,3,41,720,782,-62
218,3,42,827,731,96
218,3,43,718,833,-115
218,3,44,772,911,-139
218,3,46,1088,920,168
218,3,47,923,949,-26
218,3,48,859,922,-63
218,3,49,1015,729,286
218,3,50,676,814,-138
218,3,51,755,760,-5
218,3,52,645,912,-267
218,3,53,738,753,-15
218,3,54,798,850,-52
218,3,55,762,769,-7
218,3,56,717,974,-257
218,3,57,755,720,35
218,3,58,726,981,-255
218,3,59,713,771,-58
218,3,60,718,794,-76
218,3,61,883,689,194
218,3,62,731,776,-45
218,3,63,741,987,-246
218,3,65,793,876,-83
218,3,66,672,717,-45
218,3,67,950,887,63
218,3,68,688,823,-135
218,3,69,745,654,91
218,3,70,735,788,-53
218,3,71,767,898,-131
218,3,72,767,809,-42
219,2,1,1087,959,128
219,2,2,706,886,-180
219,2,3,1087,830,257
219,2,4,820,879,-59
219,2,5,825,820,5
219,2,6,747,752,-5
219,2,7,845,805,40
219,2,8,769,818,-49
219,2,10,923,789,134
219,2,11,1006,1011,-5
219,2,12,750,797,-47
219,2,13,858,757,101
219,2,14,855,828,27
219,2,15,717,741,-24
219,2,16,760,793,-33
219,2,17,717,720,-3
219,2,18,763,708,55
219,2,20,830,947,-117
219,2,21,785,846,-61
219,2,22,849,798,51
219,2,23,1058,1085,-27
219,2,24,746,759,-13
219,2,25,710,865,-155
219,2,27,722,896,-174
219,2,28,709,764,-55
219,2,29,820,788,32
219,2,30,1421,819,602
219,2,33,676,720,-44
219,2,34,848,912,-64
219,2,35,741,781,-40
219,2,36,818,771,47
219,2,37,794,779,15
219,2,38,1524,1741,-217
219,2,39,1124,723,401
219,2,40,795,811,-16
219,2,41,719,840,-121
219,2,42,767,778,-11
219,2,43,751,794,-43
219,2,44,881,769,112
219,2,45,699,775,-76
219,2,46,725,1333,-608
219,2,47,1119,665,454
219,2,48,740,776,-36
219,2,49,691,849,-158
219,2,50,796,828,-32
219,2,51,699,809,-110
219,2,52,828,1544,-716
219,2,53,815,1360,-545
219,2,55,724,747,-23
219,2,56,807,1198,-391
219,2,57,851,644,207
219,2,58,882,852,30
219,2,59,782,970,-188
219,2,60,850,890,-40
219,2,61,719,870,-151
219,2,62,746,935,-189
219,2,65,716,634,82
219,2,66,789,710,79
219,2,67,785,837,-52
219,2,68,785,843,-58
219,2,69,683,800,-117
219,2,70,694,1091,-397
219,2,71,821,696,125
219,2,72,740,775,-35
220,2,1,852,911,-59
220,2,2,803,834,-31
220,2,3,848,771,77
220,2,4,885,714,171
220,2,5,812,741,71
220,2,6,775,696,79
220,2,7,717,715,2
220,2,8,740,666,74
220,2,9,885,682,203
220,2,10,692,713,-21
220,2,11,775,658,117
220,2,12,803,661,142
220,2,13,685,622,63
220,2,14,769,641,128
220,2,15,779,722,57
220,2,16,717,790,-73
220,2,17,770,672,98
220,2,18,709,638,71
220,2,19,674,745,-71
220,2,20,988,715,273
220,2,21,703,706,-3
220,2,25,699,670,29
220,2,26,730,683,47
220,2,27,762,823,-61
220,2,28,848,650,198
220,2,29,730,627,103
220,2,30,743,630,113
220,2,31,779,695,84
220,2,32,721,389,332
220,2,33,743,389,354
220,2,34,751,741,10
220,2,35,796,427,369
220,2,36,550,716,-166
220,2,37,704,362,342
220,2,38,708,377,331
220,2,39,497,333,164
220,2,40,631,284,347
220,2,41,671,390,281
220,2,42,749,318,431
220,2,43,725,290,435
220,2,44,700,323,377
220,2,45,773,347,426
220,2,46,691,564,127
220,2,47,771,465,306
220,2,48,660,236,424
220,2,49,789,273,516
220,2,50,421,261,160
220,2,51,753,285,468
220,2,52,598,349,249
220,2,53,747,285,462
220,2,54,774,269,505
220,2,55,695,275,420
220,2,56,727,439,288
220,2,57,757,463,294
220,2,58,645,309,336
220,2,59,492,302,190
220,2,60,727,162,565
220,2,61,629,126,503
220,2,62,571,356,215
220,2,63,687,217,470
220,2,64,744,333,411
220,2,65,779,277,502
220,2,66,615,38,577
220,2,67,605,237,368
220,2,68,632,206,426
220,2,69,715,324,391
220,2,70,528,213,315
220,2,71,626,336,290
220,2,72,564,285,279
221,3,1,1029,1176,-147
221,3,2,900,1512,-612
221,3,3,1019,898,121
221,3,4,998,903,95
221,3,5,927,1129,-202
221,3,6,1093,1406,-313
221,3,7,1218,1073,145
221,3,8,1196,958,238
221,3,9,983,710,273
221,3,10,1019,800,219
221,3,12,1009,923,86
221,3,13,1293,694,599
221,3,14,928,987,-59
221,3,15,1073,811,262
221,3,16,1473,1044,429
221,3,17,1013,1057,-44
221,3,18,993,1137,-144
221,3,19,1046,761,285
221,3,20,1028,1126,-98
221,3,21,936,648,288
221,3,22,943,755,188
221,3,23,985,746,239
221,3,24,1591,1090,501
221,3,25,878,1447,-569
221,3,26,1074,963,111
221,3,27,1037,872,165
221,3,28,888,875,13
221,3,29,1111,841,270
221,3,30,1006,991,15
221,3,31,1096,667,429
221,3,32,1027,814,213
221,3,33,928,699,229
221,3,34,809,842,-33
221,3,35,1059,821,238
221,3,36,957,1134,-177
221,3,37,1838,1817,21
221,3,40,1778,1060,718
221,3,41,1374,1769,-395
221,3,42,992,1321,-329
221,3,43,1283,903,380
221,3,44,861,837,24
221,3,45,925,847,78
221,3,46,974,928,46
221,3,50,974,1831,-857
221,3,51,954,670,284
221,3,52,1107,1086,21
221,3,54,975,919,56
221,3,55,1172,1360,-188
221,3,56,926,859,67
221,3,60,852,716,136
221,3,61,1811,1045,766
221,3,63,1010,692,318
221,3,64,1246,810,436
221,3,66,949,630,319
221,3,67,871,710,161
221,3,69,1161,1346,-185
221,3,72,1260,1454,-194
222,2,1,866,908,-42
222,2,2,766,872,-106
222,2,3,878,655,223
222,2,4,824,760,64
222,2,5,790,777,13
222,2,6,784,663,121
222,2,7,737,619,118
222,2,8,771,629,142
222,2,9,683,614,69
222,2,10,738,611,127
222,2,11,722,501,221
222,2,13,694,665,29
222,2,14,661,554,107
222,2,15,636,568,68
222,2,16,656,617,39
222,2,17,640,585,55
222,2,20,688,674,14
222,2,21,700,680,20
222,2,22,758,873,-115
222,2,23,617,741,-124
222,2,25,760,615,145
222,2,26,659,574,85
222,2,27,704,525,179
222,2,28,642,573,69
222,2,29,716,696,20
222,2,30,696,651,45
222,2,31,702,762,-60
222,2,33,738,678,60
222,2,34,672,655,17
222,2,35,699,622,77
222,2,36,699,673,26
222,2,38,669,639,30
222,2,39,678,657,21
222,2,40,782,647,135
222,2,41,695,667,28
222,2,42,661,626,35
222,2,43,716,660,56
222,2,44,663,728,-65
222,2,45,670,689,-19
222,2,46,686,602,84
222,2,47,821,662,159
222,2,48,607,583,24
222,2,49,583,571,12
222,2,50,673,944,-271
222,2,51,704,659,45
222,2,52,784,722,62
222,2,53,556,572,-16
222,2,54,673,613,60
222,2,55,634,612,22
222,2,56,720,599,121
222,2,57,712,628,84
222,2,58,678,559,119
222,2,59,680,589,91
222,2,60,692,787,-95
222,2,61,765,731,34
222,2,62,703,574,129
222,2,63,633,640,-7
222,2,64,897,770,127
222,2,65,680,611,69
222,2,66,674,641,33
222,2,67,939,658,281
222,2,68,776,653,123
222,2,69,759,744,15
222,2,70,799,657,142
222,2,71,762,813,-51
222,2,72,707,640,67
223,3,1,1018,1004,14
223,3,2,889,956,-67
223,3,3,847,930,-83
223,3,4,820,886,-66
223,3,5,843,806,37
223,3,6,819,1157,-338
223,3,7,817,1116,-299
223,3,8,972,975,-3
223,3,10,824,722,102
223,3,11,783,1114,-331
223,3,12,1037,800,237
223,3,13,759,833,-74
223,3,14,661,800,-139
223,3,16,697,716,-19
223,3,17,809,787,22
223,3,18,754,901,-147
223,3,19,738,1204,-466
223,3,20,713,804,-91
223,3,21,874,781,93
223,3,22,817,748,69
223,3,25,1557,678,879
223,3,26,730,788,-58
223,3,27,759,714,45
223,3,28,663,722,-59
223,3,29,1035,733,302
223,3,30,706,773,-67
223,3,31,745,692,53
223,3,32,776,691,85
223,3,33,736,771,-35
223,3,34,839,930,-91
223,3,35,782,817,-35
223,3,36,820,816,4
223,3,37,774,761,13
223,3,38,814,799,15
223,3,39,780,766,14
223,3,40,739,734,5
223,3,41,812,735,77
223,3,42,700,726,-26
223,3,43,714,892,-178
223,3,44,1290,701,589
223,3,45,881,644,237
223,3,46,696,707,-11
223,3,47,718,1034,-316
223,3,48,733,720,13
223,3,49,1104,1082,22
223,3,50,1038,953,85
223,3,51,790,778,12
223,3,52,830,720,110
223,3,54,768,707,61
223,3,55,815,762,53
223,3,56,967,1007,-40
223,3,57,731,644,87
223,3,58,737,645,92
223,3,59,823,642,181
223,3,60,685,720,-35
223,3,62,717,687,30
223,3,63,748,542,206
223,3,64,751,522,229
223,3,65,720,586,134
223,3,66,742,666,76
223,3,67,750,321,429
223,3,68,717,312,405
223,3,69,725,368,357
223,3,70,685,320,365
223,3,71,820,399,421
223,3,72,727,425,302
224,3,1,841,981,-140
224,3,2,817,804,13
224,3,3,724,840,-116
224,3,4,801,1077,-276
224,3,5,841,792,49
224,3,6,758,642,116
224,3,7,852,656,196
224,3,8,786,731,55
224,3,9,680,685,-5
224,3,10,726,704,22
224,3,11,753,666,87
224,3,12,732,876,-144
224,3,13,851,680,171
224,3,14,765,591,174
224,3,15,695,646,49
224,3,17,713,682,31
224,3,18,784,658,126
224,3,19,721,697,24
224,3,20,747,669,78
224,3,21,798,684,114
224,3,22,763,743,20
224,3,23,749,801,-52
224,3,24,874,722,152
224,3,25,722,742,-20
224,3,26,721,919,-198
224,3,27,756,704,52
224,3,28,919,719,200
224,3,29,1191,686,505
224,3,30,887,674,213
224,3,31,786,793,-7
224,3,32,766,757,9
224,3,33,734,732,2
224,3,34,918,707,211
224,3,35,749,708,41
224,3,37,727,587,140
224,3,38,780,707,73
224,3,39,833,894,-61
224,3,40,1039,730,309
224,3,41,819,742,77
224,3,42,1005,838,167
224,3,43,867,894,-27
224,3,44,895,964,-69
224,3,45,804,781,23
224,3,46,986,828,158
224,3,47,721,679,42
224,3,48,740,644,96
224,3,49,729,650,79
224,3,50,680,700,-20
224,3,52,755,660,95
224,3,54,685,666,19
224,3,55,725,638,87
224,3,56,812,851,-39
224,3,57,757,670,87
224,3,59,731,696,35
224,3,60,742,683,59
224,3,61,715,663,52
224,3,62,746,625,121
224,3,63,690,744,-54
224,3,64,782,791,-9
224,3,65,643,691,-48
224,3,66,700,730,-30
224,3,67,686,688,-2
224,3,68,698,617,81
224,3,69,742,653,89
224,3,70,748,688,60
224,3,71,728,660,68
224,3,72,819,724,95
225,1,1,997,1475,-478
225,1,2,933,894,39
225,1,3,905,824,81
225,1,4,848,961,-113
225,1,5,1058,908,150
225,1,6,868,832,36
225,1,7,967,705,262
225,1,8,968,980,-12
225,1,9,921,1168,-247
225,1,10,870,968,-98
225,1,11,1057,1101,-44
225,1,12,821,760,61
225,1,13,849,791,58
225,1,14,928,779,149
225,1,15,758,1009,-251
225,1,16,784,574,210
225,1,17,818,483,335
225,1,18,1168,442,726
225,1,19,848,450,398
225,1,20,368,380,-12
225,1,21,1174,446,728
225,1,22,794,443,351
225,1,23,1366,775,591
225,1,24,930,762,168
225,1,25,1010,588,422
225,1,26,964,579,385
225,1,27,1009,544,465
225,1,28,907,1224,-317
225,1,29,763,684,79
225,1,30,951,559,392
225,1,31,1086,1067,19
225,1,32,1040,494,546
225,1,33,1042,761,281
225,1,34,807,579,228
225,1,36,703,502,201
225,1,37,765,616,149
225,1,38,787,636,151
225,1,39,891,628,263
225,1,40,984,660,324
225,1,41,935,608,327
225,1,42,1003,660,343
225,1,43,1360,563,797
225,1,44,824,857,-33
225,1,45,938,856,82
225,1,46,949,797,152
225,1,47,820,1244,-424
225,1,48,914,562,352
225,1,50,807,734,73
225,1,51,945,816,129
225,1,52,951,932,19
225,1,54,781,759,22
225,1,55,1126,654,472
225,1,56,971,860,111
225,1,58,794,1358,-564
225,1,60,716,662,54
225,1,61,736,755,-19
225,1,62,1042,611,431
225,1,63,1075,1649,-574
225,1,64,785,637,148
225,1,65,1048,777,271
225,1,67,896,1663,-767
225,1,69,887,757,130
225,1,70,978,497,481
226,2,1,1167,1201,-34
226,2,2,997,1148,-151
226,2,3,943,1063,-120
226,2,4,912,967,-55
226,2,5,940,1001,-61
226,2,6,1018,1017,1
226,2,7,930,997,-67
226,2,8,930,982,-52
226,2,9,1030,1065,-35
226,2,10,1021,1067,-46
226,2,11,922,984,-62
226,2,12,922,973,-51
226,2,13,903,835,68
226,2,14,871,975,-104
226,2,15,857,856,1
226,2,16,909,873,36
226,2,17,904,880,24
226,2,18,834,803,31
226,2,19,877,768,109
226,2,20,873,781,92
226,2,21,773,814,-41
226,2,22,864,913,-49
226,2,23,934,1065,-131
226,2,24,915,877,38
226,2,25,848,928,-80
226,2,26,828,972,-144
226,2,27,861,959,-98
226,2,28,886,826,60
226,2,29,879,848,31
226,2,30,860,842,18
226,2,31,907,870,37
226,2,32,901,929,-28
226,2,33,895,875,20
226,2,34,828,884,-56
226,2,35,874,853,21
226,2,36,826,886,-60
226,2,37,892,1078,-186
226,2,38,909,945,-36
226,2,39,904,887,17
226,2,40,924,972,-48
226,2,41,837,920,-83
226,2,42,756,970,-214
226,2,43,761,978,-217
226,2,44,843,698,145
226,2,45,779,739,40
226,2,46,748,822,-74
226,2,47,814,1116,-302
226,2,48,905,1125,-220
226,2,49,1298,816,482
226,2,50,819,1020,-201
226,2,51,888,1082,-194
226,2,52,874,868,6
226,2,53,829,1211,-382
226,2,54,921,919,2
226,2,55,900,1081,-181
226,2,56,840,1118,-278
226,2,57,798,829,-31
226,2,58,815,1015,-200
226,2,59,839,982,-143
226,2,60,1160,1126,34
226,2,61,858,805,53
226,2,62,833,805,28
226,2,63,768,749,19
226,2,64,808,1002,-194
226,2,65,883,1074,-191
226,2,66,807,948,-141
226,2,67,798,875,-77
226,2,68,827,788,39
226,2,69,900,1188,-288
226,2,70,1429,1069,360
226,2,71,784,965,-181
226,2,72,800,911,-111
227,2,1,872,1480,-608
227,2,2,824,1252,-428
227,2,3,832,972,-140
227,2,4,973,1275,-302
227,2,5,892,1008,-116
227,2,7,824,1117,-293
227,2,8,940,948,-8
227,2,9,800,1013,-213
227,2,10,792,912,-120
227,2,11,841,988,-147
227,2,12,836,993,-157
227,2,13,992,909,83
227,2,14,800,1165,-365
227,2,15,852,988,-136
227,2,16,793,796,-3
227,2,17,872,833,39
227,2,18,757,729,28
227,2,19,696,800,-104
227,2,20,866,884,-18
227,2,21,792,945,-153
227,2,22,668,796,-128
227,2,23,804,676,128
227,2,24,752,972,-220
227,2,25,859,569,290
227,2,26,712,892,-180
227,2,27,641,832,-191
227,2,28,760,464,296
227,2,29,608,424,184
227,2,30,880,420,460
227,2,31,701,476,225
227,2,32,700,344,356
227,2,33,637,344,293
227,2,34,950,336,614
227,2,35,778,352,426
227,2,36,793,384,409
227,2,37,832,396,436
227,2,38,668,457,211
227,2,39,636,468,168
227,2,40,753,380,373
227,2,41,621,332,289
227,2,42,728,408,320
227,2,43,656,592,64
227,2,44,709,345,364
227,2,45,796,4,792
227,2,46,721,496,225
227,2,47,624,36,588
227,2,48,692,36,656
227,2,50,732,228,504
227,2,51,692,20,672
227,2,52,716,613,103
227,2,54,532,56,476
227,2,55,609,144,465
227,2,56,601,68,533
227,2,57,452,392,60
227,2,58,753,16,737
227,2,59,800,289,511
227,2,61,508,136,372
227,2,62,688,28,660
227,2,63,580,256,324
227,2,65,705,316,389
227,2,66,733,80,653
227,2,67,648,188,460
227,2,68,740,524,216
227,2,69,692,341,351
227,2,70,761,404,357
227,2,71,581,220,361
227,2,72,664,52,612
228,1,1,1119,1272,-153
228,1,2,1133,1168,-35
228,1,3,1081,1514,-433
228,1,4,1140,667,473
228,1,6,901,865,36
228,1,7,1038,1035,3
228,1,8,937,656,281
228,1,9,987,526,461
228,1,10,1114,504,610
228,1,11,1242,854,388
228,1,12,1516,912,604
228,1,13,1137,889,248
228,1,14,1671,898,773
228,1,15,1074,1062,12
228,1,16,1849,764,1085
228,1,17,1533,924,609
228,1,18,1362,372,990
228,1,19,1245,915,330
228,1,20,1680,366,1314
228,1,21,1153,931,222
228,1,22,1094,876,218
228,1,23,1282,724,558
228,1,24,1047,1164,-117
228,1,25,1040,764,276
228,1,26,1116,885,231
228,1,27,1073,868,205
228,1,28,1384,779,605
228,1,29,1225,730,495
228,1,30,1441,625,816
228,1,31,1365,647,718
228,1,32,1052,457,595
228,1,33,1325,1080,245
228,1,34,1086,692,394
228,1,36,1012,464,548
228,1,37,741,223,518
228,1,38,1033,570,463
228,1,39,1182,929,253
228,1,40,1088,553,535
228,1,41,1083,619,464
228,1,42,1186,604,582
228,1,43,1181,494,687
228,1,44,1091,501,590
228,1,45,1135,514,621
228,1,46,1197,864,333
228,1,47,1130,53,1077
228,1,48,904,120,784
228,1,49,1022,397,625
228,1,50,1265,1295,-30
228,1,51,1086,944,142
228,1,52,957,298,659
228,1,53,1234,355,879
228,1,54,1375,508,867
228,1,55,1229,172,1057
228,1,56,985,424,561
228,1,57,1139,335,804
228,1,58,1121,54,1067
228,1,59,1096,448,648
228,1,60,1066,305,761
228,1,61,999,102,897
228,1,62,1150,100,1050
228,1,63,1259,410,849
228,1,64,1295,1330,-35
228,1,65,1386,1029,357
228,1,66,1245,210,1035
228,1,67,1099,466,633
228,1,68,1164,315,849
228,1,69,988,1181,-193
228,1,70,1101,686,415
228,1,71,1051,251,800
228,1,72,1151,1078,73
229,3,1,843,1115,-272
229,3,2,860,956,-96
229,3,3,930,1042,-112
229,3,4,1254,1210,44
229,3,5,1129,1071,58
229,3,6,866,910,-44
229,3,7,846,934,-88
229,3,8,908,811,97
229,3,10,814,914,-100
229,3,11,867,1041,-174
229,3,12,957,1049,-92
229,3,13,1349,913,436
229,3,14,984,802,182
229,3,15,936,942,-6
229,3,16,910,795,115
229,3,17,859,900,-41
229,3,18,833,903,-70
229,3,19,838,1012,-174
229,3,20,1013,1338,-325
229,3,21,905,945,-40
229,3,22,1004,949,55
229,3,23,844,217,627
229,3,24,885,1043,-158
229,3,25,1075,852,223
229,3,26,938,969,-31
229,3,27,1002,297,705
229,3,28,978,908,70
229,3,29,833,891,-58
229,3,30,821,1187,-366
229,3,31,758,1284,-526
229,3,32,878,1004,-126
229,3,33,859,829,30
229,3,34,938,1105,-167
229,3,35,747,867,-120
229,3,36,775,962,-187
229,3,37,986,968,18
229,3,38,816,967,-151
229,3,39,856,1216,-360
229,3,40,960,847,113
229,3,41,781,1123,-342
229,3,42,895,824,71
229,3,43,767,335,432
229,3,44,887,892,-5
229,3,45,1526,304,1222
229,3,46,778,41,737
229,3,47,821,851,-30
229,3,48,794,747,47
229,3,49,1309,885,424
229,3,50,834,871,-37
229,3,51,792,113,679
229,3,52,810,922,-112
229,3,53,830,139,691
229,3,55,864,160,704
229,3,56,842,909,-67
229,3,57,957,220,737
229,3,58,813,1055,-242
229,3,59,900,64,836
229,3,60,891,96,795
229,3,61,782,816,-34
229,3,62,787,849,-62
229,3,63,878,242,636
229,3,64,684,75,609
229,3,65,793,881,-88
229,3,66,896,66,830
229,3,67,519,169,350
229,3,68,770,528,242
229,3,69,772,892,-120
229,3,70,455,130,325
229,3,71,382,45,337
229,3,72,824,135,689
230,2,1,904,1125,-221
230,2,2,990,1013,-23
230,2,3,754,863,-109
230,2,4,853,1054,-201
230,2,5,918,900,18
230,2,6,889,551,338
230,2,8,817,786,31
230,2,9,829,759,70
230,2,10,830,739,91
230,2,11,736,740,-4
230,2,12,765,863,-98
230,2,13,868,1226,-358
230,2,14,735,676,59
230,2,15,682,774,-92
230,2,16,824,719,105
230,2,17,574,754,-180
230,2,18,780,786,-6
230,2,19,819,738,81
230,2,20,756,653,103
230,2,22,675,697,-22
230,2,23,753,1136,-383
230,2,24,753,720,33
230,2,25,735,772,-37
230,2,26,739,197,542
230,2,27,728,101,627
230,2,28,720,16,704
230,2,29,663,453,210
230,2,30,662,141,521
230,2,31,709,189,520
230,2,32,721,69,652
230,2,33,722,156,566
230,2,34,639,157,482
230,2,35,735,23,712
230,2,36,683,121,562
230,2,37,781,420,361
230,2,38,602,97,505
230,2,39,729,33,696
230,2,40,549,154,395
230,2,41,883,54,829
230,2,42,538,42,496
230,2,43,738,129,609
230,2,44,481,20,461
230,2,45,599,165,434
230,2,46,613,128,485
230,2,47,467,86,381
230,2,48,880,7,873
230,2,49,452,117,335
230,2,50,560,136,424
230,2,51,831,31,800
230,2,52,801,452,349
230,2,53,451,164,287
230,2,54,431,115,316
230,2,55,1042,16,1026
230,2,56,551,94,457
230,2,57,458,152,306
230,2,58,546,64,482
230,2,59,511,43,468
230,2,60,699,67,632
230,2,61,499,57,442
230,2,62,521,56,465
230,2,64,675,114,561
230,2,65,572,52,520
230,2,66,390,168,222
230,2,67,345,88,257
230,2,68,474,65,409
230,2,69,742,105,637
230,2,70,545,195,350
230,2,72,431,370,61
231,1,1,1071,1219,-148
231,1,2,1193,1152,41
231,1,3,956,1130,-174
231,1,4,1001,1056,-55
231,1,5,1225,977,248
231,1,6,1068,980,88
231,1,7,1269,1189,80
231,1,8,1078,1024,54
231,1,9,1143,1064,79
231,1,10,997,1271,-274
231,1,11,1274,1625,-351
231,1,12,958,1042,-84
231,1,13,1244,1069,175
231,1,14,1292,1090,202
231,1,15,982,1190,-208
231,1,16,1015,891,124
231,1,17,947,1019,-72
231,1,18,992,978,14
231,1,19,1026,1027,-1
231,1,20,1575,1109,466
231,1,21,1268,909,359
231,1,22,1278,1207,71
231,1,23,927,861,66
231,1,25,1293,934,359
231,1,26,998,962,36
231,1,27,1402,1075,327
231,1,28,1044,1211,-167
231,1,29,1184,1172,12
231,1,34,1120,898,222
231,1,38,1191,1273,-82
231,1,39,1086,944,142
231,1,40,976,1057,-81
231,1,41,997,1222,-225
231,1,42,988,957,31
231,1,44,984,1258,-274
231,1,45,1320,1233,87
231,1,48,1018,958,60
231,1,49,1305,952,353
231,1,50,1324,1148,176
231,1,51,1025,1000,25
231,1,52,986,1049,-63
231,1,53,1085,1851,-766
231,1,54,1076,1327,-251
231,1,55,1135,1041,94
231,1,56,834,1142,-308
231,1,57,1039,978,61
231,1,58,959,1122,-163
231,1,60,989,1437,-448
231,1,61,1789,1180,609
231,1,62,957,964,-7
231,1,63,821,915,-94
231,1,64,937,1186,-249
231,1,65,997,978,19
231,1,66,954,1028,-74
231,1,67,1052,894,158
231,1,68,995,950,45
231,1,69,901,939,-38
232,1,1,888,852,36
232,1,2,873,781,92
232,1,3,832,813,19
232,1,4,808,937,-129
232,1,5,857,793,64
232,1,6,972,1125,-153
232,1,7,826,961,-135
232,1,8,765,739,26
232,1,9,866,844,22
232,1,10,787,784,3
232,1,11,801,701,100
232,1,12,751,839,-88
232,1,13,1026,822,204
232,1,14,817,684,133
232,1,15,720,657,63
232,1,16,765,834,-69
232,1,17,799,692,107
232,1,19,959,740,219
232,1,20,727,774,-47
232,1,21,742,744,-2
232,1,22,754,737,17
232,1,23,799,731,68
232,1,24,757,692,65
232,1,25,761,661,100
232,1,26,743,679,64
232,1,27,696,721,-25
232,1,28,776,706,70
232,1,29,848,621,227
232,1,30,774,616,158
232,1,31,755,696,59
232,1,32,731,741,-10
232,1,33,718,758,-40
232,1,34,672,560,112
232,1,35,727,713,14
232,1,36,764,614,150
232,1,38,724,717,7
232,1,39,763,717,46
232,1,40,689,639,50
232,1,41,694,678,16
232,1,42,761,697,64
232,1,43,660,751,-91
232,1,44,767,814,-47
232,1,45,719,632,87
232,1,46,674,699,-25
232,1,47,839,679,160
232,1,48,716,654,62
232,1,49,670,703,-33
232,1,50,738,754,-16
232,1,51,775,700,75
232,1,52,696,707,-11
232,1,53,703,605,98
232,1,54,662,703,-41
232,1,55,762,659,103
232,1,56,640,625,15
232,1,57,706,633,73
232,1,58,710,687,23
232,1,59,678,683,-5
232,1,60,740,711,29
232,1,61,724,1096,-372
232,1,62,699,689,10
232,1,63,786,677,109
232,1,64,758,662,96
232,1,65,752,673,79
232,1,66,749,663,86
232,1,67,712,575,137
232,1,69,733,606,127
232,1,70,884,639,245
232,1,72,771,743,28
233,3,1,941,1364,-423
233,3,2,969,1196,-227
233,3,3,1173,1159,14
233,3,4,1042,1048,-6
233,3,5,1065,971,94
233,3,6,1028,1013,15
233,3,7,898,934,-36
233,3,8,990,954,36
233,3,9,1033,918,115
233,3,10,1107,1062,45
233,3,11,1202,1034,168
233,3,12,1025,950,75
233,3,14,1045,895,150
233,3,15,1003,1029,-26
233,3,16,1077,1129,-52
233,3,17,993,1541,-548
233,3,18,915,891,24
233,3,19,1169,1005,164
233,3,20,951,1001,-50
233,3,21,1099,948,151
233,3,22,984,1107,-123
233,3,23,968,1063,-95
233,3,24,1054,1237,-183
233,3,25,1172,1037,135
233,3,26,952,981,-29
233,3,27,919,989,-70
233,3,28,1001,1025,-24
233,3,29,1013,977,36
233,3,30,942,1019,-77
233,3,31,949,1067,-118
233,3,32,1054,1029,25
233,3,33,1115,941,174
233,3,34,997,1142,-145
233,3,35,930,1116,-186
233,3,36,875,911,-36
233,3,37,912,906,6
233,3,38,880,932,-52
233,3,39,1062,968,94
233,3,40,964,1170,-206
233,3,41,956,1029,-73
233,3,42,1248,978,270
233,3,43,1006,909,97
233,3,44,1030,1133,-103
233,3,45,961,972,-11
233,3,46,1050,886,164
233,3,47,1188,1225,-37
233,3,48,902,949,-47
233,3,49,937,1084,-147
233,3,50,1088,894,194
233,3,51,1004,894,110
233,3,52,899,948,-49
233,3,53,997,948,49
233,3,54,793,1010,-217
233,3,55,937,1001,-64
233,3,56,895,1296,-401
233,3,57,988,982,6
233,3,59,1044,963,81
233,3,60,948,940,8
233,3,61,868,1183,-315
233,3,62,1035,975,60
233,3,63,942,1237,-295
233,3,64,1020,1103,-83
233,3,65,920,974,-54
233,3,66,864,935,-71
233,3,67,910,1067,-157
233,3,68,995,942,53
233,3,69,910,873,37
233,3,70,962,846,116
233,3,71,902,890,12
233,3,72,1001,1085,-84
234,2,1,901,1083,-182
234,2,2,863,854,9
234,2,3,909,798,111
234,2,4,788,850,-62
234,2,5,851,701,150
234,2,6,784,678,106
234,2,7,787,666,121
234,2,8,748,700,48
234,2,9,817,740,77
234,2,10,841,824,17
234,2,11,765,682,83
234,2,12,752,719,33
234,2,13,833,693,140
234,2,14,785,649,136
234,2,15,739,660,79
234,2,16,851,774,77
234,2,17,770,655,115
234,2,18,718,754,-36
234,2,19,785,607,178
234,2,20,717,668,49
234,2,21,755,765,-10
234,2,22,741,735,6
234,2,23,724,667,57
234,2,24,749,701,48
234,2,25,1009,676,333
234,2,26,786,668,118
234,2,27,734,682,52
234,2,28,763,672,91
234,2,30,720,662,58
234,2,32,722,685,37
234,2,33,715,675,40
234,2,34,737,22,715
234,2,35,716,71,645
234,2,36,665,4,661
234,2,37,1145,20,1125
234,2,38,699,65,634
234,2,39,770,126,644
234,2,40,569,151,418
234,2,41,885,112,773
234,2,43,683,700,-17
234,2,45,724,38,686
234,2,46,847,99,748
234,2,47,718,85,633
234,2,50,664,113,551
234,2,51,685,736,-51
234,2,52,977,53,924
234,2,53,896,84,812
234,2,56,860,117,743
234,2,57,768,502,266
234,2,58,669,241,428
234,2,60,735,118,617
234,2,61,753,297,456
234,2,62,833,67,766
234,2,63,972,19,953
234,2,64,1089,15,1074
234,2,65,883,467,416
234,2,66,914,109,805
234,2,67,884,48,836
234,2,68,1309,204,1105
234,2,70,818,83,735
234,2,71,1370,19,1351
234,2,72,871,1336,-465
235,1,2,1059,1270,-211
235,1,3,1024,1241,-217
235,1,4,1172,1415,-243
235,1,5,1090,1448,-358
235,1,6,1297,1443,-146
235,1,7,1136,1169,-33
235,1,8,1016,1214,-198
235,1,9,1080,1222,-142
235,1,10,1207,1257,-50
235,1,11,1077,1171,-94
235,1,12,1065,1222,-157
235,1,13,1079,1482,-403
235,1,14,1180,1080,100
235,1,15,1277,1153,124
235,1,17,1123,1364,-241
235,1,18,1291,1273,18
235,1,19,956,1158,-202
235,1,20,1061,1013,48
235,1,21,1189,432,757
235,1,22,1081,470,611
235,1,23,989,599,390
235,1,24,1158,458,700
235,1,25,1010,270,740
235,1,26,1389,531,858
235,1,27,1123,640,483
235,1,28,1369,525,844
235,1,29,1192,354,838
235,1,30,1240,433,807
235,1,31,932,472,460
235,1,32,1070,9,1061
235,1,33,994,302,692
235,1,35,731,410,321
235,1,36,1086,498,588
235,1,37,1356,449,907
235,1,38,799,429,370
235,1,39,945,432,513
235,1,40,1506,330,1176
235,1,41,1108,396,712
235,1,42,1224,1093,131
235,1,43,936,575,361
235,1,45,906,722,184
235,1,46,1105,690,415
235,1,47,962,1180,-218
235,1,48,1151,1522,-371
235,1,49,1060,535,525
235,1,50,1218,414,804
235,1,51,964,408,556
235,1,53,1053,593,460
235,1,54,1097,495,602
235,1,55,1225,517,708
235,1,56,1040,710,330
235,1,57,1103,423,680
235,1,58,1362,505,857
235,1,59,1051,400,651
235,1,60,1158,492,666
235,1,63,1063,960,103
235,1,64,1179,417,762
235,1,65,1427,1046,381
235,1,66,1195,445,750
235,1,67,1096,623,473
235,1,68,1116,1037,79
235,1,69,1490,564,926
235,1,70,963,1204,-241
235,1,71,1181,1130,51
235,1,72,1030,743,287
236,1,1,1109,1088,21
236,1,2,729,1111,-382
236,1,3,841,709,132
236,1,4,784,764,20
236,1,5,819,912,-93
236,1,6,814,828,-14
236,1,7,852,850,2
236,1,8,800,829,-29
236,1,9,821,723,98
236,1,10,851,721,130
236,1,11,931,947,-16
236,1,12,961,687,274
236,1,13,891,775,116
236,1,14,803,705,98
236,1,15,809,740,69
236,1,16,810,711,99
236,1,17,817,733,84
236,1,18,729,502,227
236,1,19,783,717,66
236,1,20,711,772,-61
236,1,21,728,633,95
236,1,22,825,708,117
236,1,23,825,516,309
236,1,24,567,693,-126
236,1,25,732,634,98
236,1,26,791,708,83
236,1,27,799,651,148
236,1,28,793,598,195
236,1,29,800,685,115
236,1,30,737,542,195
236,1,31,769,542,227
236,1,32,758,419,339
236,1,33,744,341,403
236,1,34,478,380,98
236,1,35,833,447,386
236,1,36,919,258,661
236,1,37,1085,455,630
236,1,38,746,375,371
236,1,39,695,341,354
236,1,40,783,319,464
236,1,41,856,134,722
236,1,42,760,213,547
236,1,43,682,342,340
236,1,44,786,189,597
236,1,45,730,261,469
236,1,46,704,107,597
236,1,47,747,71,676
236,1,48,940,266,674
236,1,49,908,440,468
236,1,50,732,41,691
236,1,51,778,443,335
236,1,52,755,47,708
236,1,53,717,251,466
236,1,54,688,124,564
236,1,55,655,253,402
236,1,56,899,239,660
236,1,57,639,267,372
236,1,58,702,333,369
236,1,59,624,239,385
236,1,61,719,397,322
236,1,62,738,47,691
236,1,63,379,330,49
236,1,65,600,5,595
236,1,66,731,216,515
236,1,67,912,157,755
236,1,69,629,275,354
236,1,70,782,187,595
236,1,71,755,400,355
236,1,72,740,497,243
237,3,1,1139,1211,-72
237,3,2,1081,1169,-88
237,3,3,926,1302,-376
237,3,4,1000,925,75
237,3,5,1017,841,176
237,3,6,1026,954,72
237,3,7,1109,1023,86
237,3,8,994,1013,-19
237,3,9,968,954,14
237,3,10,1071,976,95
237,3,11,1018,1044,-26
237,3,12,1042,1010,32
237,3,13,1060,900,160
237,3,14,1126,895,231
237,3,15,998,994,4
237,3,16,1077,919,158
237,3,17,890,860,30
237,3,18,926,888,38
237,3,19,1052,694,358
237,3,20,927,817,110
237,3,21,1039,888,151
237,3,22,970,955,15
237,3,23,947,917,30
237,3,24,815,943,-128
237,3,25,968,891,77
237,3,26,1081,1258,-177
237,3,27,901,988,-87
237,3,28,900,884,16
237,3,29,1044,879,165
237,3,30,946,867,79
237,3,31,935,928,7
237,3,32,959,905,54
237,3,33,881,883,-2
237,3,34,982,849,133
237,3,35,888,809,79
237,3,36,942,1023,-81
237,3,37,1069,974,95
237,3,38,904,954,-50
237,3,39,986,849,137
237,3,40,844,798,46
237,3,41,958,877,81
237,3,42,1073,1027,46
237,3,43,1035,924,111
237,3,44,864,770,94
237,3,45,983,752,231
237,3,46,1047,824,223
237,3,47,1106,875,231
237,3,48,893,863,30
237,3,49,874,860,14
237,3,50,839,872,-33
237,3,51,907,900,7
237,3,52,1005,879,126
237,3,53,1048,1456,-408
237,3,54,945,841,104
237,3,55,1009,840,169
237,3,56,987,781,206
237,3,57,1011,940,71
237,3,58,1030,830,200
237,3,59,1176,1152,24
237,3,60,942,864,78
237,3,61,977,787,190
237,3,62,1040,811,229
237,3,63,890,833,57
237,3,64,1039,858,181
237,3,65,977,803,174
237,3,66,1106,829,277
237,3,67,1184,866,318
237,3,68,939,841,98
237,3,69,983,962,21
237,3,70,1122,884,238
237,3,71,841,746,95
237,3,72,992,873,119
238,1,2,879,1047,-168
238,1,3,845,1094,-249
238,1,4,935,853,82
238,1,5,1049,992,57
238,1,6,818,837,-19
238,1,7,821,924,-103
238,1,8,828,758,70
238,1,9,867,791,76
238,1,10,827,867,-40
238,1,11,801,773,28
238,1,12,795,816,-21
238,1,13,920,756,164
238,1,14,797,731,66
238,1,15,796,761,35
238,1,16,832,885,-53
238,1,17,847,947,-100
238,1,18,827,942,-115
238,1,19,810,664,146
238,1,20,810,848,-38
238,1,21,826,811,15
238,1,22,762,785,-23
238,1,23,842,836,6
238,1,24,848,887,-39
238,1,25,898,724,174
238,1,26,826,761,65
238,1,27,796,876,-80
238,1,28,848,594,254
238,1,29,767,727,40
238,1,30,734,703,31
238,1,31,805,1157,-352
238,1,32,878,997,-119
238,1,33,781,683,98
238,1,34,777,753,24
238,1,36,791,775,16
238,1,37,767,704,63
238,1,38,776,741,35
238,1,39,780,595,185
238,1,40,771,733,38
238,1,41,771,734,37
238,1,42,674,705,-31
238,1,43,761,640,121
238,1,44,785,716,69
238,1,45,763,778,-15
238,1,46,727,755,-28
238,1,47,810,732,78
238,1,48,955,728,227
238,1,50,812,779,33
238,1,51,828,699,129
238,1,52,897,708,189
238,1,53,741,653,88
238,1,54,700,662,38
238,1,55,815,672,143
238,1,56,932,753,179
238,1,57,731,699,32
238,1,58,772,636,136
238,1,59,749,661,88
238,1,60,871,656,215
238,1,61,951,825,126
238,1,62,787,897,-110
238,1,63,732,620,112
238,1,66,927,1082,-155
238,1,67,768,862,-94
238,1,68,805,984,-179
238,1,69,877,962,-85
238,1,70,786,954,-168
238,1,71,856,766,90
238,1,72,822,859,-37
239,2,1,782,860,-78
239,2,2,723,831,-108
239,2,3,998,722,276
239,2,4,774,918,-144
239,2,5,968,1050,-82
239,2,6,1025,726,299
239,2,7,770,783,-13
239,2,8,1487,579,908
239,2,9,658,690,-32
239,2,10,749,1137,-388
239,2,11,715,646,69
239,2,12,727,707,20
239,2,13,631,698,-67
239,2,14,686,585,101
239,2,15,883,635,248
239,2,16,706,603,103
239,2,17,688,639,49
239,2,18,643,623,20
239,2,19,743,747,-4
239,2,20,911,682,229
239,2,21,924,782,142
239,2,22,645,703,-58
239,2,23,709,608,101
239,2,24,737,812,-75
239,2,25,667,618,49
239,2,26,721,597,124
239,2,27,790,672,118
239,2,28,710,687,23
239,2,29,676,465,211
239,2,30,669,637,32
239,2,31,908,713,195
239,2,32,732,906,-174
239,2,33,716,1064,-348
239,2,34,664,581,83
239,2,35,807,755,52
239,2,36,797,804,-7
239,2,37,607,645,-38
239,2,38,696,573,123
239,2,39,738,783,-45
239,2,40,744,501,243
239,2,41,588,694,-106
239,2,42,1025,764,261
239,2,43,684,752,-68
239,2,44,915,825,90
239,2,45,640,989,-349
239,2,46,712,754,-42
239,2,47,873,611,262
239,2,48,784,957,-173
239,2,49,745,596,149
239,2,50,673,615,58
239,2,51,706,727,-21
239,2,52,755,766,-11
239,2,53,787,739,48
239,2,54,472,631,-159
239,2,55,713,764,-51
239,2,57,760,986,-226
239,2,58,563,1109,-546
239,2,59,1243,744,499
239,2,60,1021,665,356
239,2,61,661,602,59
239,2,62,721,889,-168
239,2,63,613,831,-218
239,2,64,686,722,-36
239,2,65,685,584,101
239,2,66,631,741,-110
239,2,67,722,578,144
239,2,68,654,637,17
239,2,69,997,574,423
239,2,70,645,644,1
239,2,71,682,696,-14
239,2,72,743,643,100
240,2,1,764,1000,-236
240,2,2,760,988,-228
240,2,3,800,808,-8
240,2,4,812,836,-24
240,2,5,872,768,104
240,2,6,844,792,52
240,2,7,900,848,52
240,2,8,744,736,8
240,2,9,757,796,-39
240,2,10,896,700,196
240,2,11,1060,892,168
240,2,12,849,832,17
240,2,13,800,797,3
240,2,14,916,764,152
240,2,15,1024,824,200
240,2,16,1205,824,381
240,2,17,852,1404,-552
240,2,18,848,1780,-932
240,2,20,1489,705,784
240,2,21,773,744,29
240,2,22,984,672,312
240,2,24,1076,708,368
240,2,25,1005,1484,-479
240,2,26,780,668,112
240,2,27,1092,1136,-44
240,2,28,892,840,52
240,2,29,1876,712,1164
240,2,30,1585,1841,-256
240,2,31,745,753,-8
240,2,32,941,700,241
240,2,34,768,780,-12
240,2,35,900,772,128
240,2,36,828,1480,-652
240,2,37,992,905,87
240,2,39,924,805,119
240,2,40,781,1008,-227
240,2,41,1112,740,372
240,2,42,880,828,52
240,2,43,1124,944,180
240,2,44,1232,1108,124
240,2,45,741,797,-56
240,2,47,1572,1752,-180
240,2,48,1828,728,1100
240,2,49,1953,896,1057
240,2,53,761,724,37
240,2,56,732,1149,-417
240,2,57,1027,1140,-113
240,2,58,736,877,-141
240,2,59,822,713,109
240,2,60,1041,933,108
240,2,61,788,788,0
240,2,63,1129,2005,-876
240,2,64,884,808,76
240,2,65,1121,1149,-28
240,2,67,980,788,192
240,2,70,1868,1172,696
241,3,1,919,1042,-123
241,3,2,939,845,94
241,3,3,1056,770,286
241,3,4,764,887,-123
241,3,5,942,753,189
241,3,6,1060,722,338
241,3,7,870,1046,-176
241,3,8,964,734,230
241,3,9,864,753,111
241,3,10,743,1042,-299
241,3,11,960,1523,-563
241,3,12,1011,857,154
241,3,13,1092,798,294
241,3,14,879,632,247
241,3,15,991,828,163
241,3,18,957,792,165
241,3,19,897,706,191
241,3,20,995,886,109
241,3,21,940,831,109
241,3,22,927,992,-65
241,3,23,917,790,127
241,3,24,803,790,13
241,3,25,865,906,-41
241,3,26,812,767,45
241,3,27,954,955,-1
241,3,28,931,747,184
241,3,29,1043,836,207
241,3,30,858,755,103
241,3,31,1264,643,621
241,3,32,818,772,46
241,3,34,929,788,141
241,3,35,899,683,216
241,3,36,1087,818,269
241,3,37,740,716,24
241,3,38,901,717,184
241,3,39,851,774,77
241,3,40,787,1293,-506
241,3,41,871,711,160
241,3,42,842,812,30
241,3,44,998,688,310
241,3,45,828,694,134
241,3,46,936,635,301
241,3,47,933,775,158
241,3,48,858,1052,-194
241,3,49,751,799,-48
241,3,50,794,709,85
241,3,51,861,853,8
241,3,52,933,797,136
241,3,53,768,807,-39
241,3,54,785,1294,-509
241,3,55,1944,924,1020
241,3,56,835,613,222
241,3,57,860,758,102
241,3,58,841,1099,-258
241,3,59,1002,877,125
241,3,60,1102,783,319
241,3,61,801,635,166
241,3,62,903,714,189
241,3,63,928,763,165
241,3,64,976,724,252
241,3,65,836,774,62
241,3,66,746,787,-41
241,3,67,1167,804,363
241,3,68,870,816,54
241,3,69,972,927,45
241,3,70,852,710,142
241,3,71,834,755,79
241,3,72,789,654,135
242,3,1,968,1090,-122
242,3,2,1032,1152,-120
242,3,3,1151,1025,126
242,3,4,1123,1100,23
242,3,5,1068,1052,16
242,3,6,1114,1044,70
242,3,7,1156,1017,139
242,3,8,1005,903,102
242,3,9,1511,1111,400
242,3,10,1076,1061,15
242,3,11,1129,1108,21
242,3,12,1147,1114,33
242,3,13,1042,918,124
242,3,14,1023,933,90
242,3,15,1015,990,25
242,3,16,1311,1138,173
242,3,17,1118,933,185
242,3,18,1182,949,233
242,3,19,984,937,47
242,3,20,1393,1278,115
242,3,21,1060,878,182
242,3,22,969,1002,-33
242,3,23,1005,910,95
242,3,24,1074,1002,72
242,3,25,991,993,-2
242,3,26,1036,873,163
242,3,27,1620,931,689
242,3,28,1039,958,81
242,3,29,1004,1075,-71
242,3,30,1033,1225,-192
242,3,31,1049,936,113
242,3,32,1015,946,69
242,3,33,1139,846,293
242,3,34,1013,901,112
242,3,35,1286,997,289
242,3,36,1047,1121,-74
242,3,37,961,999,-38
242,3,38,1314,972,342
242,3,39,1091,1303,-212
242,3,40,922,909,13
242,3,41,1135,844,291
242,3,42,972,831,141
242,3,43,869,849,20
242,3,44,865,986,-121
242,3,45,896,929,-33
242,3,46,977,894,83
242,3,47,1389,910,479
242,3,48,952,1364,-412
242,3,49,1447,799,648
242,3,50,859,832,27
242,3,51,991,928,63
242,3,52,842,843,-1
242,3,53,969,1006,-37
242,3,54,1447,1743,-296
242,3,55,938,1336,-398
242,3,56,955,1516,-561
242,3,61,1092,941,151
242,3,62,1073,981,92
242,3,63,1041,1134,-93
242,3,65,1348,988,360
242,3,72,1055,1289,-234
243,3,1,1010,1137,-127
243,3,2,915,1153,-238
243,3,3,933,1021,-88
243,3,4,911,1030,-119
243,3,5,852,838,14
243,3,6,925,900,25
243,3,7,886,731,155
243,3,8,864,779,85
243,3,9,818,919,-101
243,3,10,948,1031,-83
243,3,11,865,898,-33
243,3,13,922,712,210
243,3,14,732,771,-39
243,3,15,911,881,30
243,3,16,777,1049,-272
243,3,17,865,854,11
243,3,18,774,908,-134
243,3,19,762,780,-18
243,3,20,919,1382,-463
243,3,21,850,777,73
243,3,22,739,738,1
243,3,23,845,992,-147
243,3,24,812,1100,-288
243,3,25,1066,1971,-905
243,3,27,770,819,-49
243,3,28,814,814,0
243,3,29,1082,792,290
243,3,30,796,895,-99
243,3,31,771,838,-67
243,3,32,762,843,-81
243,3,35,827,381,446
243,3,37,1359,919,440
243,3,49,779,1414,-635
244,2,2,1137,1176,-39
244,2,3,1124,1286,-162
244,2,4,1094,1616,-522
244,2,6,980,1035,-55
244,2,7,923,1060,-137
244,2,8,993,982,11
244,2,9,1299,894,405
244,2,10,970,1387,-417
244,2,11,1117,1631,-514
244,2,12,875,1166,-291
244,2,13,838,1137,-299
244,2,14,1483,1564,-81
244,2,15,844,936,-92
244,2,16,955,1333,-378
244,2,17,980,1956,-976
244,2,19,1126,1466,-340
244,2,20,1740,1018,722
244,2,23,1052,1043,9
244,2,25,1079,1469,-390
244,2,27,1002,1202,-200
244,2,28,884,1139,-255
244,2,29,938,1041,-103
244,2,30,978,1412,-434
244,2,33,919,1931,-1012
244,2,36,991,1242,-251
244,2,37,1112,1175,-63
244,2,39,1162,1465,-303
244,2,41,939,1348,-409
244,2,42,1365,1258,107
244,2,44,949,1124,-175
244,2,46,1105,1100,5
244,2,48,897,1068,-171
244,2,49,1053,1193,-140
244,2,50,954,1306,-352
244,2,51,1207,1237,-30
244,2,53,968,1075,-107
244,2,56,944,1004,-60
244,2,57,877,1084,-207
244,2,58,943,1334,-391
244,2,60,866,1173,-307
244,2,61,989,1016,-27
244,2,62,1070,1115,-45
244,2,65,1084,505,579
244,2,69,897,1532,-635
244,2,70,975,890,85
244,2,71,1091,1433,-342
244,2,72,750,1004,-254
245,2,1,1142,1050,92
245,2,2,1085,989,96
245,2,3,985,883,102
245,2,4,1027,906,121
245,2,5,1022,853,169
245,2,6,1287,822,465
245,2,8,1161,898,263
245,2,9,1123,711,412
245,2,10,1133,1085,48
245,2,11,893,806,87
245,2,12,933,760,173
245,2,13,1053,760,293
245,2,14,974,862,112
245,2,15,875,751,124
245,2,16,919,724,195
245,2,17,1004,758,246
245,2,18,1029,843,186
245,2,19,851,841,10
245,2,20,965,863,102
245,2,21,1028,687,341
245,2,22,943,835,108
245,2,23,948,802,146
245,2,24,919,1023,-104
245,2,25,943,1460,-517
245,2,26,1169,942,227
245,2,27,1200,993,207
245,2,28,1016,935,81
245,2,29,995,781,214
245,2,30,1503,779,724
245,2,31,1087,794,293
245,2,32,1056,720,336
245,2,33,929,886,43
245,2,34,928,907,21
245,2,35,1054,765,289
245,2,36,1004,1059,-55
245,2,37,942,908,34
245,2,38,979,708,271
245,2,39,1118,718,400
245,2,40,852,820,32
245,2,41,810,729,81
245,2,42,1228,824,404
245,2,43,871,905,-34
245,2,44,1153,705,448
245,2,45,873,733,140
245,2,46,970,871,99
245,2,47,821,868,-47
245,2,48,934,833,101
245,2,49,965,1319,-354
245,2,50,816,902,-86
245,2,51,1011,875,136
245,2,52,888,793,95
245,2,53,944,858,86
245,2,54,985,820,165
245,2,55,911,764,147
245,2,56,1144,728,416
245,2,57,1231,1136,95
245,2,58,921,745,176
245,2,59,1015,716,299
245,2,60,827,705,122
245,2,61,964,727,237
245,2,62,1022,806,216
245,2,63,958,753,205
245,2,64,874,780,94
245,2,65,908,974,-66
245,2,66,928,905,23
245,2,67,1068,846,222
245,2,68,963,753,210
245,2,69,912,1133,-221
245,2,70,981,788,193
245,2,71,1174,749,425
245,2,72,868,1038,-170
246,3,1,1038,1446,-408
246,3,2,942,1249,-307
246,3,4,1048,1065,-17
246,3,5,923,1140,-217
246,3,6,1005,1011,-6
246,3,7,806,1151,-345
246,3,8,976,1095,-119
246,3,9,1055,839,216
246,3,10,782,822,-40
246,3,11,903,1039,-136
246,3,14,853,967,-114
246,3,15,1037,630,407
246,3,16,944,1225,-281
246,3,17,716,861,-145
246,3,18,868,837,31
246,3,19,773,888,-115
246,3,20,794,754,40
246,3,21,858,800,58
246,3,22,906,706,200
246,3,23,843,924,-81
246,3,24,824,834,-10
246,3,26,690,915,-225
246,3,27,747,836,-89
246,3,28,909,1013,-104
246,3,29,705,763,-58
246,3,30,818,810,8
246,3,31,810,827,-17
246,3,32,859,901,-42
246,3,33,791,984,-193
246,3,34,812,684,128
246,3,35,880,775,105
246,3,36,818,772,46
246,3,37,846,803,43
246,3,39,774,806,-32
246,3,40,771,748,23
246,3,41,708,797,-89
246,3,42,871,831,40
246,3,43,759,723,36
246,3,44,727,719,8
246,3,45,801,703,98
246,3,46,1088,743,345
246,3,47,793,842,-49
246,3,48,902,815,87
246,3,49,1013,765,248
246,3,50,794,782,12
246,3,51,770,730,40
246,3,52,732,714,18
246,3,53,807,711,96
246,3,54,706,810,-104
246,3,55,834,731,103
246,3,56,825,728,97
246,3,57,804,717,87
246,3,58,844,716,128
246,3,59,890,756,134
246,3,61,858,762,96
246,3,62,790,717,73
246,3,63,655,711,-56
246,3,64,838,789,49
246,3,65,732,701,31
246,3,66,736,697,39
246,3,67,717,701,16
246,3,68,792,697,95
246,3,69,873,667,206
246,3,70,675,659,16
246,3,71,730,907,-177
246,3,72,665,634,31
247,2,1,1470,1379,91
247,2,2,870,1058,-188
247,2,4,904,971,-67
247,2,5,918,1075,-157
247,2,6,1018,1278,-260
247,2,7,1034,1134,-100
247,2,8,860,1004,-144
247,2,9,972,1092,-120
247,2,10,893,1067,-174
247,2,11,850,1489,-639
247,2,12,1023,1153,-130
247,2,13,862,1196,-334
247,2,14,935,1046,-111
247,2,15,952,1211,-259
247,2,16,882,1314,-432
247,2,17,864,1086,-222
247,2,18,915,1071,-156
247,2,19,937,860,77
247,2,20,986,1435,-449
247,2,21,905,1066,-161
247,2,22,929,965,-36
247,2,23,876,967,-91
247,2,24,877,1077,-200
247,2,25,765,1017,-252
247,2,26,849,1243,-394
247,2,27,807,960,-153
247,2,28,944,1052,-108
247,2,29,907,962,-55
247,2,30,994,1034,-40
247,2,31,1022,1132,-110
247,2,32,849,1192,-343
247,2,33,799,1006,-207
247,2,34,935,936,-1
247,2,35,913,736,177
247,2,36,967,651,316
247,2,37,763,418,345
247,2,38,901,963,-62
247,2,39,801,564,237
247,2,40,837,571,266
247,2,41,952,120,832
247,2,42,896,444,452
247,2,44,921,435,486
247,2,45,915,759,156
247,2,46,858,1062,-204
247,2,47,831,403,428
247,2,49,969,416,553
247,2,50,705,456,249
247,2,51,841,316,525
247,2,52,908,834,74
247,2,53,848,424,424
247,2,54,875,31,844
247,2,56,663,124,539
247,2,57,685,297,388
247,2,58,436,276,160
247,2,59,568,341,227
247,2,60,845,267,578
247,2,61,822,150,672
247,2,62,790,50,740
247,2,63,792,431,361
247,2,64,386,135,251
247,2,65,773,201,572
247,2,66,832,267,565
247,2,67,872,175,697
247,2,68,621,190,431
247,2,69,834,268,566
247,2,70,548,441,107
247,2,71,692,169,523
247,2,72,950,138,812
248,3,1,653,987,-334
248,3,2,1030,889,141
248,3,3,807,829,-22
248,3,4,838,803,35
248,3,5,843,740,103
248,3,7,769,693,76
248,3,8,911,720,191
248,3,9,785,756,29
248,3,10,1271,1504,-233
248,3,11,781,640,141
248,3,12,806,757,49
248,3,13,701,728,-27
248,3,14,779,659,120
248,3,15,848,806,42
248,3,16,664,717,-53
248,3,17,690,733,-43
248,3,18,822,791,31
248,3,19,777,723,54
248,3,20,781,692,89
248,3,21,733,855,-122
248,3,22,730,651,79
248,3,23,799,695,104
248,3,24,733,947,-214
248,3,25,776,658,118
248,3,26,756,744,12
248,3,27,901,712,189
248,3,28,739,720,19
248,3,29,780,821,-41
248,3,30,792,594,198
248,3,31,969,832,137
248,3,32,804,711,93
248,3,35,1155,1092,63
248,3,36,1144,616,528
248,3,37,897,1226,-329
248,3,38,1534,975,559
248,3,39,1077,730,347
248,3,40,1049,776,273
248,3,42,1472,653,819
248,3,43,1169,727,442
248,3,46,1141,1007,134
248,3,47,1058,716,342
248,3,48,937,652,285
248,3,49,976,766,210
248,3,51,980,654,326
248,3,52,1144,778,366
248,3,55,939,666,273
248,3,56,894,733,161
248,3,57,955,821,134
248,3,58,790,856,-66
248,3,59,1182,889,293
248,3,60,789,889,-100
248,3,61,1185,660,525
248,3,62,1798,964,834
248,3,63,1067,1084,-17
248,3,65,764,842,-78
248,3,66,723,718,5
248,3,67,755,757,-2
248,3,68,1256,624,632
248,3,69,874,719,155
248,3,70,875,661,214
248,3,71,710,764,-54
248,3,72,944,743,201
249,1,1,746,784,-38
249,1,2,895,703,192
249,1,3,786,986,-200
249,1,4,733,668,65
249,1,5,811,773,38
249,1,6,1002,1040,-38
249,1,7,954,692,262
249,1,8,894,755,139
249,1,9,748,753,-5
249,1,10,890,842,48
249,1,11,876,754,122
249,1,12,528,475,53
249,1,15,734,363,371
249,1,16,912,772,140
249,1,17,779,501,278
249,1,18,1076,658,418
249,1,19,768,787,-19
249,1,20,874,850,24
249,1,21,784,565,219
249,1,22,1058,880,178
249,1,23,1043,478,565
249,1,24,1214,523,691
249,1,25,1026,847,179
249,1,26,734,646,88
249,1,28,831,564,267
249,1,29,749,511,238
249,1,30,941,765,176
249,1,31,695,544,151
249,1,32,771,845,-74
249,1,33,799,840,-41
249,1,34,840,793,47
249,1,35,697,875,-178
249,1,36,802,612,190
249,1,37,836,584,252
249,1,38,834,1232,-398
249,1,39,768,679,89
249,1,40,743,648,95
249,1,41,788,700,88
249,1,42,646,546,100
249,1,43,706,634,72
249,1,45,727,720,7
249,1,46,741,780,-39
249,1,47,815,689,126
249,1,48,678,618,60
249,1,49,793,728,65
249,1,50,728,546,182
249,1,51,827,632,195
249,1,52,965,783,182
249,1,55,945,427,518
249,1,56,757,663,94
249,1,58,777,610,167
249,1,60,721,595,126
249,1,61,729,552,177
249,1,62,736,600,136
249,1,63,810,579,231
249,1,64,765,777,-12
249,1,65,747,841,-94
249,1,66,1244,675,569
249,1,67,847,663,184
249,1,68,792,670,122
249,1,69,750,726,24
249,1,70,822,586,236
249,1,71,804,844,-40
249,1,72,805,727,78
250,2,2,1193,1293,-100
250,2,3,1358,1624,-266
250,2,4,1259,1311,-52
250,2,5,1146,1181,-35
250,2,6,1711,1067,644
250,2,7,1432,1431,1
250,2,8,1020,1499,-479
250,2,9,1880,1648,232
250,2,13,1073,1014,59
250,2,14,1138,1275,-137
250,2,15,992,1104,-112
250,2,16,1286,968,318
250,2,17,1156,906,250
250,2,18,1086,1202,-116
250,2,19,1219,1167,52
250,2,20,1406,920,486
250,2,21,1326,1436,-110
250,2,22,1340,1431,-91
250,2,23,1163,1279,-116
250,2,24,950,1851,-901
250,2,26,968,982,-14
250,2,27,1133,1113,20
250,2,28,1018,1553,-535
250,2,29,1024,1030,-6
250,2,31,967,1006,-39
250,2,32,923,1021,-98
250,2,33,788,638,150
250,2,34,1000,1766,-766
250,2,35,920,933,-13
250,2,36,978,820,158
250,2,37,930,791,139
250,2,38,1278,858,420
250,2,39,1281,827,454
250,2,40,969,770,199
250,2,42,928,1256,-328
250,2,44,848,812,36
250,2,45,817,749,68
250,2,46,767,929,-162
250,2,47,1722,1166,556
250,2,48,865,906,-41
250,2,49,957,895,62
250,2,50,867,845,22
250,2,51,947,876,71
250,2,52,1367,808,559
250,2,53,958,792,166
250,2,54,927,807,120
250,2,55,1219,929,290
250,2,56,982,1004,-22
250,2,57,1105,763,342
250,2,58,1109,1287,-178
250,2,59,1022,880,142
250,2,60,1139,1053,86
250,2,61,1030,920,110
250,2,62,1004,950,54
250,2,63,1043,791,252
250,2,64,1062,862,200
250,2,65,884,908,-24
250,2,66,954,857,97
250,2,67,949,847,102
250,2,68,929,887,42
250,2,69,1613,940,673
250,2,70,896,1054,-158
250,2,71,1406,1302,104
250,2,72,1081,983,98
251,2,1,1100,1182,-82
251,2,2,1024,1087,-63
251,2,3,1063,1183,-120
251,2,4,980,920,60
251,2,5,1115,1136,-21
251,2,6,1053,943,110
251,2,7,946,996,-50
251,2,8,1064,917,147
251,2,9,981,1049,-68
251,2,10,1044,1063,-19
251,2,11,985,981,4
251,2,12,1062,917,145
251,2,13,1007,938,69
251,2,14,1010,932,78
251,2,15,1051,970,81
251,2,16,1106,933,173
251,2,18,986,1014,-28
251,2,19,991,877,114
251,2,20,1044,990,54
251,2,21,915,878,37
251,2,22,1281,811,470
251,2,23,1128,951,177
251,2,24,974,1027,-53
251,2,25,990,866,124
251,2,26,1111,810,301
251,2,27,993,895,98
251,2,28,1053,958,95
251,2,29,956,880,76
251,2,30,1214,858,356
251,2,31,995,935,60
251,2,32,886,857,29
251,2,33,930,903,27
251,2,34,974,863,111
251,2,35,879,916,-37
251,2,36,960,1114,-154
251,2,37,971,845,126
251,2,38,896,746,150
251,2,39,934,932,2
251,2,40,934,891,43
251,2,41,981,722,259
251,2,42,868,911,-43
251,2,43,959,776,183
251,2,44,920,945,-25
251,2,45,947,856,91
251,2,46,890,943,-53
251,2,47,820,753,67
251,2,48,902,855,47
251,2,49,879,929,-50
251,2,50,940,868,72
251,2,51,928,904,24
251,2,52,1002,666,336
251,2,53,907,724,183
251,2,54,1264,882,382
251,2,55,938,642,296
251,2,56,1003,669,334
251,2,57,1009,886,123
251,2,58,896,853,43
251,2,59,858,899,-41
251,2,60,926,687,239
251,2,61,933,939,-6
251,2,62,990,684,306
251,2,63,825,651,174
251,2,64,893,870,23
251,2,65,1039,689,350
251,2,66,964,807,157
251,2,67,887,739,148
251,2,68,892,874,18
251,2,69,903,680,223
251,2,70,952,1034,-82
251,2,71,949,921,28
251,2,72,927,880,47
252,3,1,883,901,-18
252,3,2,744,798,-54
252,3,3,796,841,-45
252,3,4,799,747,52
252,3,5,749,652,97
252,3,6,775,771,4
252,3,7,774,779,-5
252,3,8,768,700,68
252,3,9,760,675,85
252,3,10,747,664,83
252,3,11,781,1318,-537
252,3,12,755,787,-32
252,3,13,737,787,-50
252,3,14,786,732,54
252,3,15,659,689,-30
252,3,16,816,675,141
252,3,17,787,727,60
252,3,18,775,763,12
252,3,19,708,614,94
252,3,20,848,694,154
252,3,21,725,752,-27
252,3,22,663,693,-30
252,3,23,694,659,35
252,3,24,801,798,3
252,3,25,629,690,-61
252,3,26,634,623,11
252,3,27,737,811,-74
252,3,28,782,793,-11
252,3,29,730,590,140
252,3,30,639,682,-43
252,3,31,694,649,45
252,3,32,706,612,94
252,3,33,749,689,60
252,3,34,752,717,35
252,3,35,814,749,65
252,3,36,701,639,62
252,3,37,701,673,28
252,3,38,683,727,-44
252,3,39,754,677,77
252,3,40,670,522,148
252,3,41,618,677,-59
252,3,42,590,754,-164
252,3,43,703,586,117
252,3,44,771,647,124
252,3,45,762,622,140
252,3,47,658,558,100
252,3,49,745,657,88
252,3,50,640,611,29
252,3,51,762,542,220
252,3,52,768,724,44
252,3,53,619,895,-276
252,3,54,705,620,85
252,3,55,701,561,140
252,3,56,728,518,210
252,3,57,714,711,3
252,3,58,791,396,395
252,3,60,719,529,190
252,3,61,723,728,-5
252,3,62,647,339,308
252,3,63,585,187,398
252,3,64,725,319,406
252,3,65,728,268,460
252,3,66,724,470,254
252,3,67,666,239,427
252,3,68,662,176,486
252,3,69,551,180,371
252,3,70,723,670,53
252,3,71,627,369,258
252,3,72,639,282,357
253,3,3,900,1272,-372
253,3,4,1092,1252,-160
253,3,5,869,964,-95
253,3,6,932,1660,-728
253,3,7,816,952,-136
253,3,8,872,1088,-216
253,3,9,936,784,152
253,3,10,852,876,-24
253,3,11,824,940,-116
253,3,12,812,1004,-192
253,3,13,848,820,28
253,3,14,893,796,97
253,3,15,836,992,-156
253,3,16,944,836,108
253,3,17,760,1012,-252
253,3,18,753,1012,-259
253,3,19,888,808,80
253,3,20,724,872,-148
253,3,21,912,793,119
253,3,22,1040,784,256
253,3,23,792,864,-72
253,3,24,884,784,100
253,3,25,748,884,-136
253,3,26,660,877,-217
253,3,27,888,981,-93
253,3,28,1380,840,540
253,3,29,769,916,-147
253,3,30,816,696,120
253,3,31,824,828,-4
253,3,32,780,632,148
253,3,33,940,680,260
253,3,34,560,616,-56
253,3,35,748,720,28
253,3,36,728,713,15
253,3,37,667,724,-57
253,3,38,702,705,-3
253,3,39,911,761,150
253,3,40,734,774,-40
253,3,41,755,676,79
253,3,42,710,764,-54
253,3,43,852,1011,-159
253,3,44,710,832,-122
253,3,45,737,728,9
253,3,46,754,748,6
253,3,47,881,740,141
253,3,48,738,812,-74
253,3,50,996,755,241
253,3,51,807,802,5
253,3,52,918,313,605
253,3,53,762,632,130
253,3,54,933,1082,-149
253,3,55,874,940,-66
253,3,56,854,781,73
253,3,57,755,1242,-487
253,3,58,631,1321,-690
253,3,59,1086,1053,33
253,3,60,843,1148,-305
253,3,61,756,697,59
253,3,62,709,762,-53
253,3,63,766,833,-67
253,3,64,723,1146,-423
253,3,67,1412,1055,357
253,3,68,730,792,-62
253,3,69,704,794,-90
253,3,70,810,670,140
253,3,71,787,1170,-383
253,3,72,739,706,33
254,2,1,1065,1177,-112
254,2,2,867,944,-77
254,2,3,844,861,-17
254,2,4,881,909,-28
254,2,5,862,662,200
254,2,6,872,847,25
254,2,7,915,903,12
254,2,9,1085,813,272
254,2,10,1357,805,552
254,2,11,900,620,280
254,2,12,836,740,96
254,2,13,1014,775,239
254,2,14,846,705,141
254,2,15,751,720,31
254,2,16,839,736,103
254,2,17,1072,1596,-524
254,2,18,1155,743,412
254,2,19,1014,826,188
254,2,20,1047,1763,-716
254,2,21,919,743,176
254,2,22,1059,748,311
254,2,23,1069,661,408
254,2,24,1178,725,453
254,2,25,1028,1473,-445
254,2,26,993,781,212
254,2,27,1137,758,379
254,2,28,1139,705,434
254,2,29,1213,748,465
254,2,30,1108,865,243
254,2,31,1157,666,491
254,2,32,1088,1062,26
254,2,33,983,1239,-256
254,2,34,1317,1325,-8
254,2,35,1021,716,305
254,2,36,952,847,105
254,2,37,1058,768,290
254,2,38,1476,792,684
254,2,39,1082,630,452
254,2,40,1405,661,744
254,2,41,1016,738,278
254,2,42,1042,747,295
254,2,43,1034,1035,-1
254,2,44,1218,977,241
254,2,45,1192,879,313
254,2,46,1019,721,298
254,2,47,1192,780,412
254,2,48,1610,1264,346
254,2,49,1512,1029,483
254,2,50,1173,755,418
254,2,51,1281,856,425
254,2,52,1352,1177,175
254,2,53,1244,775,469
254,2,54,1132,811,321
254,2,55,1361,696,665
254,2,56,1066,729,337
254,2,57,1083,702,381
254,2,58,1501,808,693
254,2,59,1128,766,362
254,2,60,1297,1064,233
254,2,61,838,714,124
254,2,62,779,627,152
254,2,63,742,665,77
254,2,64,837,669,168
254,2,65,767,715,52
254,2,66,993,740,253
254,2,67,704,594,110
254,2,68,855,663,192
254,2,69,827,654,173
254,2,70,757,711,46
254,2,71,712,680,32
254,2,72,977,749,228
255,1,1,1259,1364,-105
255,1,2,1057,1184,-127
255,1,3,969,1170,-201
255,1,4,1021,1176,-155
255,1,5,992,1192,-200
255,1,6,929,907,22
255,1,7,958,935,23
255,1,8,992,992,0
255,1,9,1030,1054,-24
255,1,10,1140,1143,-3
255,1,11,1350,999,351
255,1,12,1226,1226,0
255,1,13,959,447,512
255,1,14,1018,994,24
255,1,15,896,1081,-185
255,1,16,1152,1017,135
255,1,17,1145,609,536
255,1,18,932,1085,-153
255,1,19,1091,533,558
255,1,20,1124,1086,38
255,1,22,1013,1183,-170
255,1,23,1164,1406,-242
255,1,24,1129,1074,55
255,1,25,1141,999,142
255,1,26,927,1105,-178
255,1,27,1142,1183,-41
255,1,28,1094,606,488
255,1,29,1115,1077,38
255,1,30,1201,1003,198
255,1,31,1019,973,46
255,1,32,1445,942,503
255,1,33,1107,1116,-9
255,1,34,1214,1071,143
255,1,35,1061,726,335
255,1,36,983,529,454
255,1,37,1429,1023,406
255,1,38,1185,609,576
255,1,39,1136,146,990
255,1,40,886,350,536
255,1,41,1006,296,710
255,1,42,1131,238,893
255,1,43,1067,406,661
255,1,44,1041,179,862
255,1,45,986,267,719
255,1,46,997,1006,-9
255,1,47,1214,416,798
255,1,48,1025,322,703
255,1,49,1065,506,559
255,1,50,1235,653,582
255,1,51,922,291,631
255,1,52,1116,837,279
255,1,53,1240,473,767
255,1,54,1157,541,616
255,1,55,1062,1206,-144
255,1,56,990,328,662
255,1,57,1036,310,726
255,1,58,1041,318,723
255,1,59,1037,501,536
255,1,60,1328,442,886
255,1,61,1172,318,854
255,1,62,1082,252,830
255,1,63,1073,617,456
255,1,64,1338,483,855
255,1,65,1223,823,400
255,1,66,1056,602,454
255,1,67,1087,593,494
255,1,68,978,508,470
255,1,69,1140,701,439
255,1,70,1182,696,486
255,1,71,1128,499,629
255,1,72,1201,499,702
256,1,2,907,1193,-286
256,1,4,868,930,-62
256,1,5,847,1051,-204
256,1,6,1199,1171,28
256,1,7,997,1058,-61
256,1,8,874,1231,-357
256,1,9,896,1396,-500
256,1,10,917,1490,-573
256,1,12,902,1139,-237
256,1,13,817,1127,-310
256,1,14,940,1193,-253
256,1,15,994,934,60
256,1,16,1320,980,340
256,1,17,926,1016,-90
256,1,20,842,941,-99
256,1,21,990,1004,-14
256,1,22,1098,942,156
256,1,23,1599,931,668
256,1,25,829,915,-86
256,1,26,776,918,-142
256,1,27,799,844,-45
256,1,28,862,932,-70
256,1,29,866,779,87
256,1,30,875,801,74
256,1,31,780,794,-14
256,1,32,738,847,-109
256,1,34,848,867,-19
256,1,35,1059,793,266
256,1,37,1443,792,651
256,1,38,1066,1095,-29
256,1,39,853,849,4
256,1,40,915,1088,-173
256,1,41,1041,1078,-37
256,1,42,939,1130,-191
256,1,43,985,1236,-251
256,1,44,1325,954,371
256,1,45,876,897,-21
256,1,46,848,1005,-157
256,1,47,961,1143,-182
256,1,48,1158,1035,123
256,1,49,827,1056,-229
256,1,50,956,802,154
256,1,51,1149,931,218
256,1,52,872,908,-36
256,1,53,1076,1202,-126
256,1,54,1025,1053,-28
256,1,55,940,1290,-350
256,1,56,825,1222,-397
256,1,57,1191,949,242
256,1,58,1066,950,116
256,1,60,1033,950,83
256,1,61,800,981,-181
256,1,62,884,1055,-171
256,1,63,1546,1559,-13
256,1,65,1055,926,129
256,1,66,769,1006,-237
256,1,67,931,1225,-294
256,1,68,1123,1168,-45
256,1,69,1112,1005,107
256,1,70,1266,1311,-45
256,1,71,1019,912,107
256,1,72,1095,1427,-332
257,2,2,1041,1307,-266
257,2,3,1203,1086,117
257,2,4,1542,1101,441
257,2,5,1004,1132,-128
257,2,6,1078,1227,-149
257,2,7,1051,926,125
257,2,8,1125,943,182
257,2,9,1497,1140,357
257,2,10,1176,915,261
257,2,11,1078,1235,-157
257,2,12,1061,1007,54
257,2,13,909,832,77
257,2,14,1083,847,236
257,2,15,1067,1134,-67
257,2,16,1117,939,178
257,2,17,982,1079,-97
257,2,18,1100,1080,20
257,2,19,1260,997,263
257,2,20,1265,1104,161
257,2,21,985,876,109
257,2,22,926,886,40
257,2,23,1121,803,318
257,2,24,971,1049,-78
257,2,25,1080,991,89
257,2,26,1041,1023,18
257,2,27,1039,868,171
257,2,28,1024,844,180
257,2,29,1051,1073,-22
257,2,30,1107,1059,48
257,2,31,1325,1030,295
257,2,32,1157,976,181
257,2,33,1272,967,305
257,2,34,1270,1145,125
257,2,35,1076,1014,62
257,2,36,1048,1274,-226
257,2,37,978,1025,-47
257,2,38,1295,854,441
257,2,39,996,898,98
257,2,40,1367,917,450
257,2,41,974,880,94
257,2,42,1229,825,404
257,2,43,1054,820,234
257,2,44,1107,933,174
257,2,45,951,883,68
257,2,46,1252,900,352
257,2,47,1072,1055,17
257,2,48,989,731,258
257,2,49,1048,843,205
257,2,50,1057,1137,-80
257,2,51,1092,901,191
257,2,52,1162,852,310
257,2,53,1079,954,125
257,2,54,1174,760,414
257,2,55,1013,963,50
257,2,56,1398,1005,393
257,2,57,1071,1139,-68
257,2,58,1215,1183,32
257,2,59,984,1037,-53
257,2,60,1123,1140,-17
257,2,61,958,825,133
257,2,62,1383,835,548
257,2,63,962,874,88
257,2,64,924,927,-3
257,2,65,900,807,93
257,2,66,979,1327,-348
257,2,67,1203,956,247
257,2,68,1056,944,112
257,2,69,978,918,60
257,2,70,1010,863,147
257,2,71,997,813,184
257,2,72,941,882,59
258,3,1,826,1135,-309
258,3,2,808,998,-190
258,3,3,756,906,-150
258,3,4,1428,862,566
258,3,5,829,795,34
258,3,6,845,978,-133
258,3,7,931,898,33
258,3,8,1724,877,847
258,3,9,932,786,146
258,3,10,963,780,183
258,3,11,877,1243,-366
258,3,12,743,736,7
258,3,13,1031,929,102
258,3,14,888,666,222
258,3,15,941,749,192
258,3,16,1197,706,491
258,3,17,982,675,307
258,3,19,842,1021,-179
258,3,20,997,845,152
258,3,21,686,673,13
258,3,22,837,783,54
258,3,23,816,857,-41
258,3,24,928,814,114
258,3,25,785,673,112
258,3,26,856,673,183
258,3,27,805,718,87
258,3,28,857,623,234
258,3,29,890,736,154
258,3,30,1246,636,610
258,3,31,684,785,-101
258,3,32,840,509,331
258,3,34,745,939,-194
258,3,35,1118,820,298
258,3,36,746,715,31
258,3,37,658,697,-39
258,3,38,716,720,-4
258,3,39,939,744,195
258,3,40,679,1284,-605
258,3,41,999,949,50
258,3,42,832,882,-50
258,3,43,732,739,-7
258,3,44,835,1187,-352
258,3,45,946,760,186
258,3,46,1151,994,157
258,3,47,816,790,26
258,3,48,721,811,-90
258,3,49,828,941,-113
258,3,51,920,826,94
258,3,52,874,723,151
258,3,53,938,705,233
258,3,54,1071,817,254
258,3,55,887,757,130
258,3,56,667,780,-113
258,3,57,900,917,-17
258,3,58,1009,782,227
258,3,59,914,1396,-482
258,3,60,891,925,-34
258,3,61,684,745,-61
258,3,62,765,726,39
258,3,64,881,1115,-234
258,3,65,955,884,71
258,3,66,836,660,176
258,3,67,849,767,82
258,3,68,813,783,30
258,3,69,870,619,251
258,3,70,743,704,39
258,3,71,792,874,-82
258,3,72,781,771,10
